Zip Code,Date,Total Doses - Daily,Total Doses - Cumulative,1st Dose - Daily,1st Dose - Cumulative,1st Dose - Percent Population,Vaccine Series Completed - Daily,Vaccine Series Completed - Cumulative,Vaccine Series Completed  - Percent Population,Population,ZIP Code Location,Row_ID
60601,03/05/2021,95,4331,61,2650,0.176,34,1681,0.111,15083,POINT (-87.622844 41.886262),60601-20210305
60601,03/06/2021,34,4365,17,2667,0.177,17,1698,0.113,15083,POINT (-87.622844 41.886262),60601-20210306
60602,03/06/2021,6,726,2,440,0.384,4,286,0.25,1145,POINT (-87.628309 41.883136),60602-20210306
60603,03/06/2021,8,771,4,486,0.462,4,285,0.271,1052,POINT (-87.625473 41.880112),60603-20210306
60605,03/02/2021,171,9970,94,5991,0.206,77,3979,0.137,29060,POINT (-87.623449 41.867824),60605-20210302
60605,03/03/2021,234,10204,91,6082,0.209,143,4122,0.142,29060,POINT (-87.623449 41.867824),60605-20210303
60606,03/06/2021,9,1144,6,701,0.213,3,443,0.135,3287,POINT (-87.63676 41.882634),60606-20210306
60607,02/15/2021,103,7645,54,4946,0.169,49,2699,0.092,29293,POINT (-87.652727 41.876104),60607-20210215
60607,02/16/2021,100,7745,63,5009,0.171,37,2736,0.093,29293,POINT (-87.652727 41.876104),60607-20210216
60607,02/17/2021,167,7912,75,5084,0.174,92,2828,0.097,29293,POINT (-87.652727 41.876104),60607-20210217
60607,02/18/2021,171,8083,67,5151,0.176,104,2932,0.1,29293,POINT (-87.652727 41.876104),60607-20210218
60607,02/19/2021,164,8247,72,5223,0.178,92,3024,0.103,29293,POINT (-87.652727 41.876104),60607-20210219
60607,02/20/2021,81,8328,22,5245,0.179,59,3083,0.105,29293,POINT (-87.652727 41.876104),60607-20210220
60607,02/21/2021,28,8356,7,5252,0.179,21,3104,0.106,29293,POINT (-87.652727 41.876104),60607-20210221
60607,02/22/2021,132,8488,57,5309,0.181,75,3179,0.109,29293,POINT (-87.652727 41.876104),60607-20210222
60607,02/23/2021,279,8767,68,5377,0.184,211,3390,0.116,29293,POINT (-87.652727 41.876104),60607-20210223
60607,02/24/2021,202,8969,72,5449,0.186,130,3520,0.12,29293,POINT (-87.652727 41.876104),60607-20210224
60607,02/25/2021,181,9150,72,5521,0.188,109,3629,0.124,29293,POINT (-87.652727 41.876104),60607-20210225
60607,02/26/2021,191,9341,63,5584,0.191,128,3757,0.128,29293,POINT (-87.652727 41.876104),60607-20210226
60607,02/27/2021,128,9469,83,5667,0.193,45,3802,0.13,29293,POINT (-87.652727 41.876104),60607-20210227
60607,02/28/2021,30,9499,15,5682,0.194,15,3817,0.13,29293,POINT (-87.652727 41.876104),60607-20210228
60607,03/01/2021,108,9607,59,5741,0.196,49,3866,0.132,29293,POINT (-87.652727 41.876104),60607-20210301
60607,03/02/2021,122,9729,60,5801,0.198,62,3928,0.134,29293,POINT (-87.652727 41.876104),60607-20210302
60605,02/04/2021,217,6032,171,4037,0.139,46,1995,0.069,29060,POINT (-87.623449 41.867824),60605-20210204
60607,03/03/2021,222,9951,93,5894,0.201,129,4057,0.138,29293,POINT (-87.652727 41.876104),60607-20210303
60607,03/04/2021,170,10121,91,5985,0.204,79,4136,0.141,29293,POINT (-87.652727 41.876104),60607-20210304
60607,03/05/2021,214,10335,128,6113,0.209,86,4222,0.144,29293,POINT (-87.652727 41.876104),60607-20210305
60607,03/06/2021,69,10404,38,6151,0.21,31,4253,0.145,29293,POINT (-87.652727 41.876104),60607-20210306
60608,03/06/2021,337,17943,218,11873,0.148,119,6070,0.076,80059,POINT (-87.670366 41.849879),60608-20210306
60602,02/02/2021,15,311,9,245,0.214,6,66,0.058,1145,POINT (-87.628309 41.883136),60602-20210202
60609,02/18/2021,233,5989,125,4631,0.076,108,1358,0.022,60939,POINT (-87.653382 41.812017),60609-20210218
60609,02/19/2021,227,6216,113,4744,0.078,114,1472,0.024,60939,POINT (-87.653382 41.812017),60609-20210219
60609,02/20/2021,136,6352,78,4822,0.079,58,1530,0.025,60939,POINT (-87.653382 41.812017),60609-20210220
60609,02/21/2021,31,6383,16,4838,0.079,15,1545,0.025,60939,POINT (-87.653382 41.812017),60609-20210221
60609,02/22/2021,192,6575,105,4943,0.081,87,1632,0.027,60939,POINT (-87.653382 41.812017),60609-20210222
60609,02/23/2021,275,6850,182,5125,0.084,93,1725,0.028,60939,POINT (-87.653382 41.812017),60609-20210223
60609,02/26/2021,401,7783,191,5577,0.092,210,2206,0.036,60939,POINT (-87.653382 41.812017),60609-20210226
60609,02/27/2021,235,8018,164,5741,0.094,71,2277,0.037,60939,POINT (-87.653382 41.812017),60609-20210227
60609,02/28/2021,61,8079,40,5781,0.095,21,2298,0.038,60939,POINT (-87.653382 41.812017),60609-20210228
60609,03/01/2021,297,8376,186,5967,0.098,111,2409,0.04,60939,POINT (-87.653382 41.812017),60609-20210301
60609,03/02/2021,263,8639,137,6104,0.1,126,2535,0.042,60939,POINT (-87.653382 41.812017),60609-20210302
60609,03/03/2021,349,8988,146,6250,0.103,203,2738,0.045,60939,POINT (-87.653382 41.812017),60609-20210303
60609,03/05/2021,337,9628,202,6617,0.109,135,3011,0.049,60939,POINT (-87.653382 41.812017),60609-20210305
60609,03/06/2021,205,9833,123,6740,0.111,82,3093,0.051,60939,POINT (-87.653382 41.812017),60609-20210306
60610,02/27/2021,165,11076,95,6969,0.172,70,4107,0.101,40548,POINT (-87.63581 41.90455),60610-20210227
60610,02/28/2021,67,11143,31,7000,0.173,36,4143,0.102,40548,POINT (-87.63581 41.90455),60610-20210228
60610,03/01/2021,151,11294,78,7078,0.175,73,4216,0.104,40548,POINT (-87.63581 41.90455),60610-20210301
60610,03/02/2021,195,11489,107,7185,0.177,88,4304,0.106,40548,POINT (-87.63581 41.90455),60610-20210302
60610,03/03/2021,358,11847,128,7313,0.18,230,4534,0.112,40548,POINT (-87.63581 41.90455),60610-20210303
60610,03/04/2021,318,12165,216,7529,0.186,102,4636,0.114,40548,POINT (-87.63581 41.90455),60610-20210304
60610,03/05/2021,404,12569,239,7768,0.192,165,4801,0.118,40548,POINT (-87.63581 41.90455),60610-20210305
60610,03/06/2021,94,12663,43,7811,0.193,51,4852,0.12,40548,POINT (-87.63581 41.90455),60610-20210306
60611,02/20/2021,139,13811,28,8455,0.254,111,5356,0.161,33224,POINT (-87.620291 41.894734),60611-20210220
60611,02/21/2021,45,13856,8,8463,0.255,37,5393,0.162,33224,POINT (-87.620291 41.894734),60611-20210221
60611,02/22/2021,150,14006,42,8505,0.256,108,5501,0.166,33224,POINT (-87.620291 41.894734),60611-20210222
60611,02/23/2021,322,14328,200,8705,0.262,122,5623,0.169,33224,POINT (-87.620291 41.894734),60611-20210223
60611,02/24/2021,219,14547,93,8798,0.265,126,5749,0.173,33224,POINT (-87.620291 41.894734),60611-20210224
60611,02/25/2021,393,14940,88,8886,0.267,305,6054,0.182,33224,POINT (-87.620291 41.894734),60611-20210225
60603,12/15/2020,0,0,0,0,0,0,0,0,1052,POINT (-87.625473 41.880112),60603-20201215
60603,12/16/2020,0,0,0,0,0,0,0,0,1052,POINT (-87.625473 41.880112),60603-20201216
60603,12/17/2020,8,8,8,8,0.008,0,0,0,1052,POINT (-87.625473 41.880112),60603-20201217
60603,12/18/2020,6,14,6,14,0.013,0,0,0,1052,POINT (-87.625473 41.880112),60603-20201218
60603,12/19/2020,4,18,4,18,0.017,0,0,0,1052,POINT (-87.625473 41.880112),60603-20201219
60603,12/20/2020,5,23,5,23,0.022,0,0,0,1052,POINT (-87.625473 41.880112),60603-20201220
60603,12/21/2020,5,28,5,28,0.027,0,0,0,1052,POINT (-87.625473 41.880112),60603-20201221
60603,12/22/2020,7,35,7,35,0.033,0,0,0,1052,POINT (-87.625473 41.880112),60603-20201222
60603,12/23/2020,0,35,0,35,0.033,0,0,0,1052,POINT (-87.625473 41.880112),60603-20201223
60603,12/24/2020,1,36,1,36,0.034,0,0,0,1052,POINT (-87.625473 41.880112),60603-20201224
60603,12/25/2020,0,36,0,36,0.034,0,0,0,1052,POINT (-87.625473 41.880112),60603-20201225
60603,12/26/2020,0,36,0,36,0.034,0,0,0,1052,POINT (-87.625473 41.880112),60603-20201226
60603,12/27/2020,0,36,0,36,0.034,0,0,0,1052,POINT (-87.625473 41.880112),60603-20201227
60603,12/28/2020,1,37,1,37,0.035,0,0,0,1052,POINT (-87.625473 41.880112),60603-20201228
60603,12/29/2020,2,39,2,39,0.037,0,0,0,1052,POINT (-87.625473 41.880112),60603-20201229
60603,12/30/2020,3,42,3,42,0.04,0,0,0,1052,POINT (-87.625473 41.880112),60603-20201230
60603,12/31/2020,1,43,1,43,0.041,0,0,0,1052,POINT (-87.625473 41.880112),60603-20201231
60603,01/01/2021,0,43,0,43,0.041,0,0,0,1052,POINT (-87.625473 41.880112),60603-20210101
60603,01/02/2021,0,43,0,43,0.041,0,0,0,1052,POINT (-87.625473 41.880112),60603-20210102
60603,01/03/2021,0,43,0,43,0.041,0,0,0,1052,POINT (-87.625473 41.880112),60603-20210103
60603,01/04/2021,2,45,2,45,0.043,0,0,0,1052,POINT (-87.625473 41.880112),60603-20210104
60603,01/05/2021,3,48,2,47,0.045,1,1,0.001,1052,POINT (-87.625473 41.880112),60603-20210105
60603,01/06/2021,1,49,1,48,0.046,0,1,0.001,1052,POINT (-87.625473 41.880112),60603-20210106
60603,01/07/2021,11,60,1,49,0.047,10,11,0.01,1052,POINT (-87.625473 41.880112),60603-20210107
60603,01/08/2021,9,69,2,51,0.048,7,18,0.017,1052,POINT (-87.625473 41.880112),60603-20210108
60603,01/09/2021,42,111,37,88,0.084,5,23,0.022,1052,POINT (-87.625473 41.880112),60603-20210109
60603,01/10/2021,3,114,1,89,0.085,2,25,0.024,1052,POINT (-87.625473 41.880112),60603-20210110
60603,01/11/2021,1,115,0,89,0.085,1,26,0.025,1052,POINT (-87.625473 41.880112),60603-20210111
60603,01/12/2021,7,122,1,90,0.086,6,32,0.03,1052,POINT (-87.625473 41.880112),60603-20210112
60603,01/13/2021,2,124,2,92,0.087,0,32,0.03,1052,POINT (-87.625473 41.880112),60603-20210113
60603,01/14/2021,6,130,5,97,0.092,1,33,0.031,1052,POINT (-87.625473 41.880112),60603-20210114
60603,01/15/2021,11,141,11,108,0.103,0,33,0.031,1052,POINT (-87.625473 41.880112),60603-20210115
60603,01/16/2021,35,176,35,143,0.136,0,33,0.031,1052,POINT (-87.625473 41.880112),60603-20210116
60603,01/17/2021,2,178,2,145,0.138,0,33,0.031,1052,POINT (-87.625473 41.880112),60603-20210117
60603,01/18/2021,3,181,3,148,0.141,0,33,0.031,1052,POINT (-87.625473 41.880112),60603-20210118
60603,01/19/2021,0,181,0,148,0.141,0,33,0.031,1052,POINT (-87.625473 41.880112),60603-20210119
60603,01/20/2021,7,188,7,155,0.147,0,33,0.031,1052,POINT (-87.625473 41.880112),60603-20210120
60603,01/21/2021,13,201,10,165,0.157,3,36,0.034,1052,POINT (-87.625473 41.880112),60603-20210121
60603,01/22/2021,23,224,23,188,0.179,0,36,0.034,1052,POINT (-87.625473 41.880112),60603-20210122
60603,01/23/2021,9,233,9,197,0.187,0,36,0.034,1052,POINT (-87.625473 41.880112),60603-20210123
60603,01/24/2021,2,235,1,198,0.188,1,37,0.035,1052,POINT (-87.625473 41.880112),60603-20210124
60603,01/25/2021,4,239,3,201,0.191,1,38,0.036,1052,POINT (-87.625473 41.880112),60603-20210125
60603,01/26/2021,6,245,4,205,0.195,2,40,0.038,1052,POINT (-87.625473 41.880112),60603-20210126
60603,01/27/2021,68,313,68,273,0.26,0,40,0.038,1052,POINT (-87.625473 41.880112),60603-20210127
60603,01/28/2021,9,322,7,280,0.266,2,42,0.04,1052,POINT (-87.625473 41.880112),60603-20210128
60603,01/29/2021,8,330,7,287,0.273,1,43,0.041,1052,POINT (-87.625473 41.880112),60603-20210129
60603,01/30/2021,9,339,8,295,0.28,1,44,0.042,1052,POINT (-87.625473 41.880112),60603-20210130
60603,01/31/2021,0,339,0,295,0.28,0,44,0.042,1052,POINT (-87.625473 41.880112),60603-20210131
60603,02/01/2021,3,342,2,297,0.282,1,45,0.043,1052,POINT (-87.625473 41.880112),60603-20210201
60603,02/02/2021,9,351,5,302,0.287,4,49,0.047,1052,POINT (-87.625473 41.880112),60603-20210202
60603,02/03/2021,18,369,17,319,0.303,1,50,0.048,1052,POINT (-87.625473 41.880112),60603-20210203
60603,02/04/2021,10,379,5,324,0.308,5,55,0.052,1052,POINT (-87.625473 41.880112),60603-20210204
60603,02/05/2021,13,392,7,331,0.315,6,61,0.058,1052,POINT (-87.625473 41.880112),60603-20210205
60603,02/06/2021,38,430,12,343,0.326,26,87,0.083,1052,POINT (-87.625473 41.880112),60603-20210206
60603,02/07/2021,2,432,2,345,0.328,0,87,0.083,1052,POINT (-87.625473 41.880112),60603-20210207
60603,02/08/2021,8,440,6,351,0.334,2,89,0.085,1052,POINT (-87.625473 41.880112),60603-20210208
60603,02/09/2021,14,454,12,363,0.345,2,91,0.087,1052,POINT (-87.625473 41.880112),60603-20210209
60603,02/10/2021,18,472,16,379,0.36,2,93,0.088,1052,POINT (-87.625473 41.880112),60603-20210210
60603,02/11/2021,9,481,1,380,0.361,8,101,0.096,1052,POINT (-87.625473 41.880112),60603-20210211
60603,02/12/2021,19,500,5,385,0.366,14,115,0.109,1052,POINT (-87.625473 41.880112),60603-20210212
60603,02/13/2021,7,507,4,389,0.37,3,118,0.112,1052,POINT (-87.625473 41.880112),60603-20210213
60603,02/14/2021,4,511,3,392,0.373,1,119,0.113,1052,POINT (-87.625473 41.880112),60603-20210214
60603,02/15/2021,4,515,2,394,0.375,2,121,0.115,1052,POINT (-87.625473 41.880112),60603-20210215
60601,02/01/2021,45,1893,29,1372,0.091,16,521,0.035,15083,POINT (-87.622844 41.886262),60601-20210201
60601,02/24/2021,85,3539,41,2286,0.152,44,1253,0.083,15083,POINT (-87.622844 41.886262),60601-20210224
60601,02/25/2021,141,3680,48,2334,0.155,93,1346,0.089,15083,POINT (-87.622844 41.886262),60601-20210225
60601,02/26/2021,151,3831,41,2375,0.157,110,1456,0.097,15083,POINT (-87.622844 41.886262),60601-20210226
60601,02/27/2021,51,3882,29,2404,0.159,22,1478,0.098,15083,POINT (-87.622844 41.886262),60601-20210227
60601,02/28/2021,24,3906,10,2414,0.16,14,1492,0.099,15083,POINT (-87.622844 41.886262),60601-20210228
60601,03/01/2021,56,3962,31,2445,0.162,25,1517,0.101,15083,POINT (-87.622844 41.886262),60601-20210301
60611,02/26/2021,454,15394,105,8991,0.271,349,6403,0.193,33224,POINT (-87.620291 41.894734),60611-20210226
60611,02/27/2021,122,15516,75,9066,0.273,47,6450,0.194,33224,POINT (-87.620291 41.894734),60611-20210227
60611,02/28/2021,68,15584,28,9094,0.274,40,6490,0.195,33224,POINT (-87.620291 41.894734),60611-20210228
60611,03/01/2021,131,15715,57,9151,0.275,74,6564,0.198,33224,POINT (-87.620291 41.894734),60611-20210301
60611,03/02/2021,184,15899,86,9237,0.278,98,6662,0.201,33224,POINT (-87.620291 41.894734),60611-20210302
60604,12/15/2020,0,0,0,0,0,0,0,0,823,POINT (-87.629029 41.878153),60604-20201215
60604,12/16/2020,0,0,0,0,0,0,0,0,823,POINT (-87.629029 41.878153),60604-20201216
60604,12/17/2020,0,0,0,0,0,0,0,0,823,POINT (-87.629029 41.878153),60604-20201217
60604,12/18/2020,5,5,5,5,0.006,0,0,0,823,POINT (-87.629029 41.878153),60604-20201218
60604,12/19/2020,0,5,0,5,0.006,0,0,0,823,POINT (-87.629029 41.878153),60604-20201219
60604,12/20/2020,0,5,0,5,0.006,0,0,0,823,POINT (-87.629029 41.878153),60604-20201220
60604,12/21/2020,0,5,0,5,0.006,0,0,0,823,POINT (-87.629029 41.878153),60604-20201221
60604,12/22/2020,0,5,0,5,0.006,0,0,0,823,POINT (-87.629029 41.878153),60604-20201222
60604,12/23/2020,1,6,1,6,0.007,0,0,0,823,POINT (-87.629029 41.878153),60604-20201223
60604,12/24/2020,1,7,1,7,0.009,0,0,0,823,POINT (-87.629029 41.878153),60604-20201224
60604,12/25/2020,0,7,0,7,0.009,0,0,0,823,POINT (-87.629029 41.878153),60604-20201225
60604,12/27/2020,0,7,0,7,0.009,0,0,0,823,POINT (-87.629029 41.878153),60604-20201227
60604,12/28/2020,1,8,1,8,0.01,0,0,0,823,POINT (-87.629029 41.878153),60604-20201228
60604,12/29/2020,1,9,1,9,0.011,0,0,0,823,POINT (-87.629029 41.878153),60604-20201229
60604,12/30/2020,1,10,1,10,0.012,0,0,0,823,POINT (-87.629029 41.878153),60604-20201230
60604,12/31/2020,1,11,1,11,0.013,0,0,0,823,POINT (-87.629029 41.878153),60604-20201231
60604,01/01/2021,0,11,0,11,0.013,0,0,0,823,POINT (-87.629029 41.878153),60604-20210101
60604,01/02/2021,0,11,0,11,0.013,0,0,0,823,POINT (-87.629029 41.878153),60604-20210102
60604,01/03/2021,0,11,0,11,0.013,0,0,0,823,POINT (-87.629029 41.878153),60604-20210103
60604,01/04/2021,1,12,1,12,0.015,0,0,0,823,POINT (-87.629029 41.878153),60604-20210104
60604,01/05/2021,2,14,2,14,0.017,0,0,0,823,POINT (-87.629029 41.878153),60604-20210105
60604,01/06/2021,1,15,1,15,0.018,0,0,0,823,POINT (-87.629029 41.878153),60604-20210106
60604,01/07/2021,3,18,1,16,0.019,2,2,0.002,823,POINT (-87.629029 41.878153),60604-20210107
60604,01/08/2021,4,22,2,18,0.022,2,4,0.005,823,POINT (-87.629029 41.878153),60604-20210108
60604,01/09/2021,2,24,1,19,0.023,1,5,0.006,823,POINT (-87.629029 41.878153),60604-20210109
60604,01/10/2021,0,24,0,19,0.023,0,5,0.006,823,POINT (-87.629029 41.878153),60604-20210110
60604,01/11/2021,1,25,1,20,0.024,0,5,0.006,823,POINT (-87.629029 41.878153),60604-20210111
60604,01/12/2021,0,25,0,20,0.024,0,5,0.006,823,POINT (-87.629029 41.878153),60604-20210112
60604,01/13/2021,10,35,9,29,0.035,1,6,0.007,823,POINT (-87.629029 41.878153),60604-20210113
60604,01/14/2021,4,39,3,32,0.039,1,7,0.009,823,POINT (-87.629029 41.878153),60604-20210114
60604,01/15/2021,3,42,3,35,0.043,0,7,0.009,823,POINT (-87.629029 41.878153),60604-20210115
60604,01/16/2021,2,44,2,37,0.045,0,7,0.009,823,POINT (-87.629029 41.878153),60604-20210116
60604,01/17/2021,3,47,3,40,0.049,0,7,0.009,823,POINT (-87.629029 41.878153),60604-20210117
60604,01/18/2021,0,47,0,40,0.049,0,7,0.009,823,POINT (-87.629029 41.878153),60604-20210118
60604,01/19/2021,9,56,7,47,0.057,2,9,0.011,823,POINT (-87.629029 41.878153),60604-20210119
60604,01/20/2021,3,59,3,50,0.061,0,9,0.011,823,POINT (-87.629029 41.878153),60604-20210120
60604,01/21/2021,9,68,7,57,0.069,2,11,0.013,823,POINT (-87.629029 41.878153),60604-20210121
60604,01/22/2021,8,76,8,65,0.079,0,11,0.013,823,POINT (-87.629029 41.878153),60604-20210122
60604,01/23/2021,5,81,5,70,0.085,0,11,0.013,823,POINT (-87.629029 41.878153),60604-20210123
60604,01/24/2021,2,83,2,72,0.087,0,11,0.013,823,POINT (-87.629029 41.878153),60604-20210124
60604,01/25/2021,21,104,21,93,0.113,0,11,0.013,823,POINT (-87.629029 41.878153),60604-20210125
60604,01/26/2021,19,123,18,111,0.135,1,12,0.015,823,POINT (-87.629029 41.878153),60604-20210126
60604,01/27/2021,15,138,14,125,0.152,1,13,0.016,823,POINT (-87.629029 41.878153),60604-20210127
60604,01/28/2021,20,158,19,144,0.175,1,14,0.017,823,POINT (-87.629029 41.878153),60604-20210128
60604,01/29/2021,22,180,20,164,0.199,2,16,0.019,823,POINT (-87.629029 41.878153),60604-20210129
60604,01/30/2021,1,181,1,165,0.2,0,16,0.019,823,POINT (-87.629029 41.878153),60604-20210130
60604,01/31/2021,2,183,1,166,0.202,1,17,0.021,823,POINT (-87.629029 41.878153),60604-20210131
60604,02/01/2021,5,188,5,171,0.208,0,17,0.021,823,POINT (-87.629029 41.878153),60604-20210201
60604,02/02/2021,8,196,7,178,0.216,1,18,0.022,823,POINT (-87.629029 41.878153),60604-20210202
60604,02/03/2021,7,203,6,184,0.224,1,19,0.023,823,POINT (-87.629029 41.878153),60604-20210203
60604,02/04/2021,5,208,5,189,0.23,0,19,0.023,823,POINT (-87.629029 41.878153),60604-20210204
60604,02/05/2021,10,218,8,197,0.239,2,21,0.026,823,POINT (-87.629029 41.878153),60604-20210205
60604,02/06/2021,3,221,1,198,0.241,2,23,0.028,823,POINT (-87.629029 41.878153),60604-20210206
60604,02/07/2021,1,222,1,199,0.242,0,23,0.028,823,POINT (-87.629029 41.878153),60604-20210207
60604,02/08/2021,9,231,8,207,0.252,1,24,0.029,823,POINT (-87.629029 41.878153),60604-20210208
60604,02/09/2021,19,250,14,221,0.269,5,29,0.035,823,POINT (-87.629029 41.878153),60604-20210209
60604,02/10/2021,18,268,8,229,0.278,10,39,0.047,823,POINT (-87.629029 41.878153),60604-20210210
60604,02/11/2021,18,286,11,240,0.292,7,46,0.056,823,POINT (-87.629029 41.878153),60604-20210211
60604,02/12/2021,14,300,4,244,0.296,10,56,0.068,823,POINT (-87.629029 41.878153),60604-20210212
60604,02/13/2021,6,306,2,246,0.299,4,60,0.073,823,POINT (-87.629029 41.878153),60604-20210213
60604,02/14/2021,2,308,0,246,0.299,2,62,0.075,823,POINT (-87.629029 41.878153),60604-20210214
60604,02/15/2021,0,308,0,246,0.299,0,62,0.075,823,POINT (-87.629029 41.878153),60604-20210215
60604,02/16/2021,5,313,4,250,0.304,1,63,0.077,823,POINT (-87.629029 41.878153),60604-20210216
60604,02/17/2021,6,319,2,252,0.306,4,67,0.081,823,POINT (-87.629029 41.878153),60604-20210217
60604,02/18/2021,8,327,4,256,0.311,4,71,0.086,823,POINT (-87.629029 41.878153),60604-20210218
60604,02/19/2021,7,334,3,259,0.315,4,75,0.091,823,POINT (-87.629029 41.878153),60604-20210219
60604,02/20/2021,2,336,1,260,0.316,1,76,0.092,823,POINT (-87.629029 41.878153),60604-20210220
60604,02/21/2021,5,341,2,262,0.318,3,79,0.096,823,POINT (-87.629029 41.878153),60604-20210221
60604,02/22/2021,27,368,3,265,0.322,24,103,0.125,823,POINT (-87.629029 41.878153),60604-20210222
60604,02/23/2021,28,396,5,270,0.328,23,126,0.153,823,POINT (-87.629029 41.878153),60604-20210223
60611,03/03/2021,364,16263,98,9335,0.281,266,6928,0.209,33224,POINT (-87.620291 41.894734),60611-20210303
60611,03/04/2021,320,16583,202,9537,0.287,118,7046,0.212,33224,POINT (-87.620291 41.894734),60611-20210304
60611,03/05/2021,288,16871,182,9719,0.293,106,7152,0.215,33224,POINT (-87.620291 41.894734),60611-20210305
60611,03/06/2021,71,16942,29,9748,0.293,42,7194,0.217,33224,POINT (-87.620291 41.894734),60611-20210306
60612,03/06/2021,81,8375,41,5207,0.154,40,3168,0.094,33735,POINT (-87.687011 41.88004),60612-20210306
60608,02/04/2021,413,6966,328,5574,0.07,85,1392,0.017,80059,POINT (-87.670366 41.849879),60608-20210204
60613,02/06/2021,170,7548,117,5622,0.111,53,1926,0.038,50761,POINT (-87.661343 41.953742),60613-20210206
60613,02/07/2021,58,7606,47,5669,0.112,11,1937,0.038,50761,POINT (-87.661343 41.953742),60613-20210207
60613,02/08/2021,290,7896,153,5822,0.115,137,2074,0.041,50761,POINT (-87.661343 41.953742),60613-20210208
60613,02/09/2021,369,8265,173,5995,0.118,196,2270,0.045,50761,POINT (-87.661343 41.953742),60613-20210209
60613,02/10/2021,396,8661,286,6281,0.124,110,2380,0.047,50761,POINT (-87.661343 41.953742),60613-20210210
60613,02/11/2021,374,9035,205,6486,0.128,169,2549,0.05,50761,POINT (-87.661343 41.953742),60613-20210211
60613,02/12/2021,404,9439,228,6714,0.132,176,2725,0.054,50761,POINT (-87.661343 41.953742),60613-20210212
60613,02/13/2021,259,9698,173,6887,0.136,86,2811,0.055,50761,POINT (-87.661343 41.953742),60613-20210213
60613,02/14/2021,69,9767,44,6931,0.137,25,2836,0.056,50761,POINT (-87.661343 41.953742),60613-20210214
60613,02/15/2021,159,9926,105,7036,0.139,54,2890,0.057,50761,POINT (-87.661343 41.953742),60613-20210215
60613,02/16/2021,212,10138,147,7183,0.142,65,2955,0.058,50761,POINT (-87.661343 41.953742),60613-20210216
60613,02/17/2021,255,10393,125,7308,0.144,130,3085,0.061,50761,POINT (-87.661343 41.953742),60613-20210217
60613,02/18/2021,294,10687,113,7421,0.146,181,3266,0.064,50761,POINT (-87.661343 41.953742),60613-20210218
60613,02/19/2021,319,11006,133,7554,0.149,186,3452,0.068,50761,POINT (-87.661343 41.953742),60613-20210219
60613,02/20/2021,160,11166,44,7598,0.15,116,3568,0.07,50761,POINT (-87.661343 41.953742),60613-20210220
60613,02/21/2021,90,11256,29,7627,0.15,61,3629,0.071,50761,POINT (-87.661343 41.953742),60613-20210221
60613,02/22/2021,242,11498,62,7689,0.151,180,3809,0.075,50761,POINT (-87.661343 41.953742),60613-20210222
60613,02/23/2021,337,11835,170,7859,0.155,167,3976,0.078,50761,POINT (-87.661343 41.953742),60613-20210223
60613,02/24/2021,341,12176,144,8003,0.158,197,4173,0.082,50761,POINT (-87.661343 41.953742),60613-20210224
60613,02/25/2021,378,12554,149,8152,0.161,229,4402,0.087,50761,POINT (-87.661343 41.953742),60613-20210225
60613,02/26/2021,430,12984,178,8330,0.164,252,4654,0.092,50761,POINT (-87.661343 41.953742),60613-20210226
60613,02/27/2021,313,13297,193,8523,0.168,120,4774,0.094,50761,POINT (-87.661343 41.953742),60613-20210227
60613,02/28/2021,120,13417,59,8582,0.169,61,4835,0.095,50761,POINT (-87.661343 41.953742),60613-20210228
60613,03/01/2021,233,13650,124,8706,0.172,109,4944,0.097,50761,POINT (-87.661343 41.953742),60613-20210301
60613,03/02/2021,284,13934,147,8853,0.174,137,5081,0.1,50761,POINT (-87.661343 41.953742),60613-20210302
60613,03/03/2021,347,14281,171,9024,0.178,176,5257,0.104,50761,POINT (-87.661343 41.953742),60613-20210303
60613,03/04/2021,345,14626,205,9229,0.182,140,5397,0.106,50761,POINT (-87.661343 41.953742),60613-20210304
60609,02/05/2021,249,3558,217,2899,0.048,32,659,0.011,60939,POINT (-87.653382 41.812017),60609-20210205
60613,03/05/2021,337,14963,201,9430,0.186,136,5533,0.109,50761,POINT (-87.661343 41.953742),60613-20210305
60613,03/06/2021,183,15146,101,9531,0.188,82,5615,0.111,50761,POINT (-87.661343 41.953742),60613-20210306
60614,02/18/2021,469,15057,191,10288,0.143,278,4769,0.066,71954,POINT (-87.652064 41.922605),60614-20210218
60614,02/19/2021,482,15539,135,10423,0.145,347,5116,0.071,71954,POINT (-87.652064 41.922605),60614-20210219
60614,02/20/2021,209,15748,66,10489,0.146,143,5259,0.073,71954,POINT (-87.652064 41.922605),60614-20210220
60614,02/21/2021,95,15843,28,10517,0.146,67,5326,0.074,71954,POINT (-87.652064 41.922605),60614-20210221
60614,02/22/2021,407,16250,105,10622,0.148,302,5628,0.078,71954,POINT (-87.652064 41.922605),60614-20210222
60614,02/23/2021,500,16750,263,10885,0.151,237,5865,0.082,71954,POINT (-87.652064 41.922605),60614-20210223
60614,02/24/2021,455,17205,191,11076,0.154,264,6129,0.085,71954,POINT (-87.652064 41.922605),60614-20210224
60614,02/25/2021,511,17716,139,11215,0.156,372,6501,0.09,71954,POINT (-87.652064 41.922605),60614-20210225
60614,02/26/2021,592,18308,214,11429,0.159,378,6879,0.096,71954,POINT (-87.652064 41.922605),60614-20210226
60614,02/27/2021,344,18652,182,11611,0.161,162,7041,0.098,71954,POINT (-87.652064 41.922605),60614-20210227
60614,02/28/2021,162,18814,81,11692,0.162,81,7122,0.099,71954,POINT (-87.652064 41.922605),60614-20210228
60614,03/01/2021,327,19141,166,11858,0.165,161,7283,0.101,71954,POINT (-87.652064 41.922605),60614-20210301
60614,03/02/2021,359,19500,202,12060,0.168,157,7440,0.103,71954,POINT (-87.652064 41.922605),60614-20210302
60614,03/03/2021,523,20023,235,12295,0.171,288,7728,0.107,71954,POINT (-87.652064 41.922605),60614-20210303
60614,03/04/2021,469,20492,279,12574,0.175,190,7918,0.11,71954,POINT (-87.652064 41.922605),60614-20210304
60614,03/05/2021,487,20979,314,12888,0.179,173,8091,0.112,71954,POINT (-87.652064 41.922605),60614-20210305
60614,03/06/2021,184,21163,97,12985,0.18,87,8178,0.114,71954,POINT (-87.652064 41.922605),60614-20210306
60615,02/27/2021,154,11076,102,6588,0.162,52,4488,0.111,40590,POINT (-87.602725 41.801993),60615-20210227
60615,03/06/2021,96,12353,51,7304,0.18,45,5049,0.124,40590,POINT (-87.602725 41.801993),60615-20210306
60616,02/18/2021,329,9342,148,6757,0.125,181,2585,0.048,54197,POINT (-87.629531 41.844869),60616-20210218
60616,02/19/2021,330,9672,135,6892,0.127,195,2780,0.051,54197,POINT (-87.629531 41.844869),60616-20210219
60616,02/20/2021,236,9908,106,6998,0.129,130,2910,0.054,54197,POINT (-87.629531 41.844869),60616-20210220
60616,02/21/2021,38,9946,9,7007,0.129,29,2939,0.054,54197,POINT (-87.629531 41.844869),60616-20210221
60616,02/22/2021,193,10139,83,7090,0.131,110,3049,0.056,54197,POINT (-87.629531 41.844869),60616-20210222
60616,02/23/2021,304,10443,105,7195,0.133,199,3248,0.06,54197,POINT (-87.629531 41.844869),60616-20210223
60616,02/24/2021,641,11084,405,7600,0.14,236,3484,0.064,54197,POINT (-87.629531 41.844869),60616-20210224
60616,02/25/2021,374,11458,140,7740,0.143,234,3718,0.069,54197,POINT (-87.629531 41.844869),60616-20210225
60616,02/26/2021,376,11834,142,7882,0.145,234,3952,0.073,54197,POINT (-87.629531 41.844869),60616-20210226
60616,02/27/2021,294,12128,190,8072,0.149,104,4056,0.075,54197,POINT (-87.629531 41.844869),60616-20210227
60616,02/28/2021,100,12228,63,8135,0.15,37,4093,0.076,54197,POINT (-87.629531 41.844869),60616-20210228
60616,03/01/2021,259,12487,131,8266,0.153,128,4221,0.078,54197,POINT (-87.629531 41.844869),60616-20210301
60616,03/02/2021,322,12809,128,8394,0.155,194,4415,0.081,54197,POINT (-87.629531 41.844869),60616-20210302
60616,03/03/2021,386,13195,151,8545,0.158,235,4650,0.086,54197,POINT (-87.629531 41.844869),60616-20210303
60608,01/13/2021,164,2199,93,1708,0.021,71,491,0.006,80059,POINT (-87.670366 41.849879),60608-20210113
60608,01/14/2021,123,2322,98,1806,0.023,25,516,0.006,80059,POINT (-87.670366 41.849879),60608-20210114
60608,01/15/2021,86,2408,78,1884,0.024,8,524,0.007,80059,POINT (-87.670366 41.849879),60608-20210115
60608,01/16/2021,57,2465,52,1936,0.024,5,529,0.007,80059,POINT (-87.670366 41.849879),60608-20210116
60608,01/17/2021,13,2478,10,1946,0.024,3,532,0.007,80059,POINT (-87.670366 41.849879),60608-20210117
60608,01/18/2021,93,2571,57,2003,0.025,36,568,0.007,80059,POINT (-87.670366 41.849879),60608-20210118
60608,01/19/2021,140,2711,76,2079,0.026,64,632,0.008,80059,POINT (-87.670366 41.849879),60608-20210119
60608,01/20/2021,308,3019,220,2299,0.029,88,720,0.009,80059,POINT (-87.670366 41.849879),60608-20210120
60608,01/21/2021,326,3345,261,2560,0.032,65,785,0.01,80059,POINT (-87.670366 41.849879),60608-20210121
60608,01/22/2021,251,3596,239,2799,0.035,12,797,0.01,80059,POINT (-87.670366 41.849879),60608-20210122
60608,01/23/2021,145,3741,138,2937,0.037,7,804,0.01,80059,POINT (-87.670366 41.849879),60608-20210123
60608,01/24/2021,36,3777,34,2971,0.037,2,806,0.01,80059,POINT (-87.670366 41.849879),60608-20210124
60608,01/25/2021,253,4030,184,3155,0.039,69,875,0.011,80059,POINT (-87.670366 41.849879),60608-20210125
60608,01/26/2021,207,4237,154,3309,0.041,53,928,0.012,80059,POINT (-87.670366 41.849879),60608-20210126
60608,01/27/2021,333,4570,281,3590,0.045,52,980,0.012,80059,POINT (-87.670366 41.849879),60608-20210127
60608,01/28/2021,314,4884,260,3850,0.048,54,1034,0.013,80059,POINT (-87.670366 41.849879),60608-20210128
60608,01/29/2021,370,5254,310,4160,0.052,60,1094,0.014,80059,POINT (-87.670366 41.849879),60608-20210129
60608,01/31/2021,35,5521,31,4385,0.055,4,1136,0.014,80059,POINT (-87.670366 41.849879),60608-20210131
60608,02/01/2021,251,5772,222,4607,0.058,29,1165,0.015,80059,POINT (-87.670366 41.849879),60608-20210201
60611,01/22/2021,496,6518,469,4485,0.135,27,2033,0.061,33224,POINT (-87.620291 41.894734),60611-20210122
60611,01/23/2021,141,6659,135,4620,0.139,6,2039,0.061,33224,POINT (-87.620291 41.894734),60611-20210123
60611,01/24/2021,57,6716,53,4673,0.141,4,2043,0.061,33224,POINT (-87.620291 41.894734),60611-20210124
60611,01/25/2021,170,6886,134,4807,0.145,36,2079,0.063,33224,POINT (-87.620291 41.894734),60611-20210125
60611,01/26/2021,456,7342,125,4932,0.148,331,2410,0.073,33224,POINT (-87.620291 41.894734),60611-20210126
60611,01/27/2021,213,7555,149,5081,0.153,64,2474,0.074,33224,POINT (-87.620291 41.894734),60611-20210127
60611,01/28/2021,403,7958,300,5381,0.162,103,2577,0.078,33224,POINT (-87.620291 41.894734),60611-20210128
60611,01/29/2021,370,8328,340,5721,0.172,30,2607,0.078,33224,POINT (-87.620291 41.894734),60611-20210129
60611,01/30/2021,94,8422,71,5792,0.174,23,2630,0.079,33224,POINT (-87.620291 41.894734),60611-20210130
60611,01/31/2021,40,8462,28,5820,0.175,12,2642,0.08,33224,POINT (-87.620291 41.894734),60611-20210131
60611,02/01/2021,107,8569,80,5900,0.178,27,2669,0.08,33224,POINT (-87.620291 41.894734),60611-20210201
60611,02/02/2021,278,8847,131,6031,0.182,147,2816,0.085,33224,POINT (-87.620291 41.894734),60611-20210202
60611,02/03/2021,175,9022,132,6163,0.185,43,2859,0.086,33224,POINT (-87.620291 41.894734),60611-20210203
60611,02/04/2021,349,9371,314,6477,0.195,35,2894,0.087,33224,POINT (-87.620291 41.894734),60611-20210204
60611,02/05/2021,683,10054,386,6863,0.207,297,3191,0.096,33224,POINT (-87.620291 41.894734),60611-20210205
60611,02/06/2021,107,10161,70,6933,0.209,37,3228,0.097,33224,POINT (-87.620291 41.894734),60611-20210206
60611,02/07/2021,40,10201,33,6966,0.21,7,3235,0.097,33224,POINT (-87.620291 41.894734),60611-20210207
60611,02/08/2021,233,10434,98,7064,0.213,135,3370,0.101,33224,POINT (-87.620291 41.894734),60611-20210208
60616,03/05/2021,458,14009,278,9012,0.166,180,4997,0.092,54197,POINT (-87.629531 41.844869),60616-20210305
60617,02/27/2021,320,11496,200,7969,0.095,120,3527,0.042,83553,POINT (-87.556897 41.721257),60617-20210227
60617,02/28/2021,125,11621,65,8034,0.096,60,3587,0.043,83553,POINT (-87.556897 41.721257),60617-20210228
60617,03/01/2021,280,11901,173,8207,0.098,107,3694,0.044,83553,POINT (-87.556897 41.721257),60617-20210301
60617,03/02/2021,280,12181,116,8323,0.1,164,3858,0.046,83553,POINT (-87.556897 41.721257),60617-20210302
60617,03/03/2021,476,12657,189,8512,0.102,287,4145,0.05,83553,POINT (-87.556897 41.721257),60617-20210303
60617,03/04/2021,485,13142,295,8807,0.105,190,4335,0.052,83553,POINT (-87.556897 41.721257),60617-20210304
60617,03/05/2021,504,13646,331,9138,0.109,173,4508,0.054,83553,POINT (-87.556897 41.721257),60617-20210305
60617,03/06/2021,261,13907,100,9238,0.111,161,4669,0.056,83553,POINT (-87.556897 41.721257),60617-20210306
60618,02/14/2021,136,12995,101,9769,0.103,35,3226,0.034,94907,POINT (-87.703343 41.946699),60618-20210214
60618,02/15/2021,280,13275,201,9970,0.105,79,3305,0.035,94907,POINT (-87.703343 41.946699),60618-20210215
60618,02/16/2021,296,13571,210,10180,0.107,86,3391,0.036,94907,POINT (-87.703343 41.946699),60618-20210216
60618,02/17/2021,465,14036,240,10420,0.11,225,3616,0.038,94907,POINT (-87.703343 41.946699),60618-20210217
60618,02/18/2021,508,14544,254,10674,0.112,254,3870,0.041,94907,POINT (-87.703343 41.946699),60618-20210218
60618,02/19/2021,472,15016,233,10907,0.115,239,4109,0.043,94907,POINT (-87.703343 41.946699),60618-20210219
60618,02/20/2021,261,15277,109,11016,0.116,152,4261,0.045,94907,POINT (-87.703343 41.946699),60618-20210220
60618,02/21/2021,124,15401,60,11076,0.117,64,4325,0.046,94907,POINT (-87.703343 41.946699),60618-20210221
60618,02/22/2021,333,15734,107,11183,0.118,226,4551,0.048,94907,POINT (-87.703343 41.946699),60618-20210222
60618,02/23/2021,455,16189,207,11390,0.12,248,4799,0.051,94907,POINT (-87.703343 41.946699),60618-20210223
60618,02/24/2021,514,16703,225,11615,0.122,289,5088,0.054,94907,POINT (-87.703343 41.946699),60618-20210224
60618,02/25/2021,708,17411,301,11916,0.126,407,5495,0.058,94907,POINT (-87.703343 41.946699),60618-20210225
60618,02/26/2021,617,18028,312,12228,0.129,305,5800,0.061,94907,POINT (-87.703343 41.946699),60618-20210226
60618,02/27/2021,457,18485,268,12496,0.132,189,5989,0.063,94907,POINT (-87.703343 41.946699),60618-20210227
60618,02/28/2021,177,18662,79,12575,0.132,98,6087,0.064,94907,POINT (-87.703343 41.946699),60618-20210228
60612,01/18/2021,38,1978,20,1446,0.043,18,532,0.016,33735,POINT (-87.687011 41.88004),60612-20210118
60612,01/27/2021,170,3128,135,2189,0.065,35,939,0.028,33735,POINT (-87.687011 41.88004),60612-20210127
60612,01/28/2021,182,3310,135,2324,0.069,47,986,0.029,33735,POINT (-87.687011 41.88004),60612-20210128
60612,01/29/2021,173,3483,141,2465,0.073,32,1018,0.03,33735,POINT (-87.687011 41.88004),60612-20210129
60612,01/30/2021,60,3543,49,2514,0.075,11,1029,0.031,33735,POINT (-87.687011 41.88004),60612-20210130
60612,01/31/2021,43,3586,37,2551,0.076,6,1035,0.031,33735,POINT (-87.687011 41.88004),60612-20210131
60612,02/01/2021,99,3685,82,2633,0.078,17,1052,0.031,33735,POINT (-87.687011 41.88004),60612-20210201
60612,02/02/2021,172,3857,115,2748,0.081,57,1109,0.033,33735,POINT (-87.687011 41.88004),60612-20210202
60612,02/03/2021,195,4052,124,2872,0.085,71,1180,0.035,33735,POINT (-87.687011 41.88004),60612-20210203
60612,02/04/2021,174,4226,132,3004,0.089,42,1222,0.036,33735,POINT (-87.687011 41.88004),60612-20210204
60618,03/01/2021,469,19131,238,12813,0.135,231,6318,0.067,94907,POINT (-87.703343 41.946699),60618-20210301
60618,03/02/2021,568,19699,324,13137,0.138,244,6562,0.069,94907,POINT (-87.703343 41.946699),60618-20210302
60618,03/03/2021,690,20389,367,13504,0.142,323,6885,0.073,94907,POINT (-87.703343 41.946699),60618-20210303
60618,03/04/2021,628,21017,334,13838,0.146,294,7179,0.076,94907,POINT (-87.703343 41.946699),60618-20210304
60618,03/05/2021,621,21638,372,14210,0.15,249,7428,0.078,94907,POINT (-87.703343 41.946699),60618-20210305
60618,03/06/2021,400,22038,180,14390,0.152,220,7648,0.081,94907,POINT (-87.703343 41.946699),60618-20210306
60619,03/03/2021,318,10080,163,6662,0.109,155,3418,0.056,61207,POINT (-87.60569 41.744737),60619-20210303
60619,03/04/2021,313,10393,198,6860,0.112,115,3533,0.058,61207,POINT (-87.60569 41.744737),60619-20210304
60619,03/05/2021,364,10757,240,7100,0.116,124,3657,0.06,61207,POINT (-87.60569 41.744737),60619-20210305
60619,03/06/2021,165,10922,85,7185,0.117,80,3737,0.061,61207,POINT (-87.60569 41.744737),60619-20210306
60620,02/03/2021,325,2903,208,2375,0.035,117,528,0.008,67711,POINT (-87.651656 41.740873),60620-20210203
60620,02/04/2021,248,3151,222,2597,0.038,26,554,0.008,67711,POINT (-87.651656 41.740873),60620-20210204
60620,02/05/2021,232,3383,186,2783,0.041,46,600,0.009,67711,POINT (-87.651656 41.740873),60620-20210205
60620,02/06/2021,112,3495,93,2876,0.042,19,619,0.009,67711,POINT (-87.651656 41.740873),60620-20210206
60620,02/07/2021,47,3542,47,2923,0.043,0,619,0.009,67711,POINT (-87.651656 41.740873),60620-20210207
60620,02/08/2021,181,3723,158,3081,0.046,23,642,0.009,67711,POINT (-87.651656 41.740873),60620-20210208
60620,02/09/2021,231,3954,168,3249,0.048,63,705,0.01,67711,POINT (-87.651656 41.740873),60620-20210209
60620,02/10/2021,275,4229,217,3466,0.051,58,763,0.011,67711,POINT (-87.651656 41.740873),60620-20210210
60620,02/11/2021,323,4552,222,3688,0.054,101,864,0.013,67711,POINT (-87.651656 41.740873),60620-20210211
60620,02/12/2021,224,4776,151,3839,0.057,73,937,0.014,67711,POINT (-87.651656 41.740873),60620-20210212
60620,02/13/2021,223,4999,177,4016,0.059,46,983,0.015,67711,POINT (-87.651656 41.740873),60620-20210213
60620,02/14/2021,42,5041,38,4054,0.06,4,987,0.015,67711,POINT (-87.651656 41.740873),60620-20210214
60620,02/15/2021,150,5191,100,4154,0.061,50,1037,0.015,67711,POINT (-87.651656 41.740873),60620-20210215
60620,02/16/2021,78,5269,43,4197,0.062,35,1072,0.016,67711,POINT (-87.651656 41.740873),60620-20210216
60620,02/17/2021,192,5461,100,4297,0.063,92,1164,0.017,67711,POINT (-87.651656 41.740873),60620-20210217
60620,02/18/2021,326,5787,217,4514,0.067,109,1273,0.019,67711,POINT (-87.651656 41.740873),60620-20210218
60620,02/19/2021,285,6072,158,4672,0.069,127,1400,0.021,67711,POINT (-87.651656 41.740873),60620-20210219
60620,02/20/2021,109,6181,56,4728,0.07,53,1453,0.021,67711,POINT (-87.651656 41.740873),60620-20210220
60620,02/21/2021,79,6260,63,4791,0.071,16,1469,0.022,67711,POINT (-87.651656 41.740873),60620-20210221
60620,02/22/2021,157,6417,91,4882,0.072,66,1535,0.023,67711,POINT (-87.651656 41.740873),60620-20210222
60620,02/23/2021,205,6622,111,4993,0.074,94,1629,0.024,67711,POINT (-87.651656 41.740873),60620-20210223
60620,02/24/2021,204,6826,103,5096,0.075,101,1730,0.026,67711,POINT (-87.651656 41.740873),60620-20210224
60620,02/25/2021,341,7167,145,5241,0.077,196,1926,0.028,67711,POINT (-87.651656 41.740873),60620-20210225
60620,02/26/2021,414,7581,214,5455,0.081,200,2126,0.031,67711,POINT (-87.651656 41.740873),60620-20210226
60620,02/27/2021,260,7841,167,5622,0.083,93,2219,0.033,67711,POINT (-87.651656 41.740873),60620-20210227
60620,02/28/2021,101,7942,64,5686,0.084,37,2256,0.033,67711,POINT (-87.651656 41.740873),60620-20210228
60620,03/01/2021,235,8177,145,5831,0.086,90,2346,0.035,67711,POINT (-87.651656 41.740873),60620-20210301
60620,03/02/2021,314,8491,184,6015,0.089,130,2476,0.037,67711,POINT (-87.651656 41.740873),60620-20210302
60620,03/03/2021,355,8846,182,6197,0.092,173,2649,0.039,67711,POINT (-87.651656 41.740873),60620-20210303
60620,03/05/2021,346,9596,222,6620,0.098,124,2976,0.044,67711,POINT (-87.651656 41.740873),60620-20210305
60620,03/06/2021,194,9790,93,6713,0.099,101,3077,0.045,67711,POINT (-87.651656 41.740873),60620-20210306
60621,02/20/2021,34,2116,22,1621,0.058,12,495,0.018,28018,POINT (-87.638812 41.776931),60621-20210220
60621,02/21/2021,4,2120,4,1625,0.058,0,495,0.018,28018,POINT (-87.638812 41.776931),60621-20210221
60621,02/22/2021,181,2301,122,1747,0.062,59,554,0.02,28018,POINT (-87.638812 41.776931),60621-20210222
60621,02/23/2021,117,2418,102,1849,0.066,15,569,0.02,28018,POINT (-87.638812 41.776931),60621-20210223
60621,02/24/2021,93,2511,34,1883,0.067,59,628,0.022,28018,POINT (-87.638812 41.776931),60621-20210224
60621,02/25/2021,93,2604,53,1936,0.069,40,668,0.024,28018,POINT (-87.638812 41.776931),60621-20210225
60621,02/26/2021,105,2709,57,1993,0.071,48,716,0.026,28018,POINT (-87.638812 41.776931),60621-20210226
60621,02/27/2021,54,2763,46,2039,0.073,8,724,0.026,28018,POINT (-87.638812 41.776931),60621-20210227
60621,02/28/2021,9,2772,7,2046,0.073,2,726,0.026,28018,POINT (-87.638812 41.776931),60621-20210228
60621,03/01/2021,101,2873,76,2122,0.076,25,751,0.027,28018,POINT (-87.638812 41.776931),60621-20210301
60621,03/02/2021,78,2951,43,2165,0.077,35,786,0.028,28018,POINT (-87.638812 41.776931),60621-20210302
60621,03/03/2021,118,3069,64,2229,0.08,54,840,0.03,28018,POINT (-87.638812 41.776931),60621-20210303
60621,03/04/2021,110,3179,70,2299,0.082,40,880,0.031,28018,POINT (-87.638812 41.776931),60621-20210304
60621,03/05/2021,107,3286,81,2380,0.085,26,906,0.032,28018,POINT (-87.638812 41.776931),60621-20210305
60621,03/06/2021,47,3333,23,2403,0.086,24,930,0.033,28018,POINT (-87.638812 41.776931),60621-20210306
60622,03/02/2021,313,14621,174,9294,0.174,139,5327,0.1,53294,POINT (-87.681818 41.902762),60622-20210302
60622,03/03/2021,302,14923,168,9462,0.178,134,5461,0.102,53294,POINT (-87.681818 41.902762),60622-20210303
60612,01/15/2021,104,1904,85,1395,0.041,19,509,0.015,33735,POINT (-87.687011 41.88004),60612-20210115
60612,01/16/2021,29,1933,28,1423,0.042,1,510,0.015,33735,POINT (-87.687011 41.88004),60612-20210116
60612,01/17/2021,7,1940,3,1426,0.042,4,514,0.015,33735,POINT (-87.687011 41.88004),60612-20210117
60612,01/19/2021,129,2107,48,1494,0.044,81,613,0.018,33735,POINT (-87.687011 41.88004),60612-20210119
60612,01/20/2021,220,2327,131,1625,0.048,89,702,0.021,33735,POINT (-87.687011 41.88004),60612-20210120
60612,01/21/2021,232,2559,185,1810,0.054,47,749,0.022,33735,POINT (-87.687011 41.88004),60612-20210121
60612,01/22/2021,116,2675,93,1903,0.056,23,772,0.023,33735,POINT (-87.687011 41.88004),60612-20210122
60612,01/23/2021,43,2718,39,1942,0.058,4,776,0.023,33735,POINT (-87.687011 41.88004),60612-20210123
60612,01/24/2021,5,2723,5,1947,0.058,0,776,0.023,33735,POINT (-87.687011 41.88004),60612-20210124
60612,01/25/2021,129,2852,51,1998,0.059,78,854,0.025,33735,POINT (-87.687011 41.88004),60612-20210125
60612,01/26/2021,106,2958,56,2054,0.061,50,904,0.027,33735,POINT (-87.687011 41.88004),60612-20210126
60614,01/15/2021,276,4505,255,3234,0.045,21,1271,0.018,71954,POINT (-87.652064 41.922605),60614-20210115
60614,01/16/2021,103,4608,80,3314,0.046,23,1294,0.018,71954,POINT (-87.652064 41.922605),60614-20210116
60614,01/17/2021,56,4664,32,3346,0.047,24,1318,0.018,71954,POINT (-87.652064 41.922605),60614-20210117
60614,01/18/2021,302,4966,228,3574,0.05,74,1392,0.019,71954,POINT (-87.652064 41.922605),60614-20210118
60614,01/19/2021,296,5262,190,3764,0.052,106,1498,0.021,71954,POINT (-87.652064 41.922605),60614-20210119
60614,01/20/2021,254,5516,168,3932,0.055,86,1584,0.022,71954,POINT (-87.652064 41.922605),60614-20210120
60614,01/21/2021,373,5889,315,4247,0.059,58,1642,0.023,71954,POINT (-87.652064 41.922605),60614-20210121
60614,01/22/2021,440,6329,398,4645,0.065,42,1684,0.023,71954,POINT (-87.652064 41.922605),60614-20210122
60612,01/09/2021,56,1300,16,1093,0.032,40,207,0.006,33735,POINT (-87.687011 41.88004),60612-20210109
60612,01/10/2021,13,1313,6,1099,0.033,7,214,0.006,33735,POINT (-87.687011 41.88004),60612-20210110
60612,01/11/2021,120,1433,26,1125,0.033,94,308,0.009,33735,POINT (-87.687011 41.88004),60612-20210111
60612,01/12/2021,136,1569,62,1187,0.035,74,382,0.011,33735,POINT (-87.687011 41.88004),60612-20210112
60612,01/13/2021,131,1700,58,1245,0.037,73,455,0.013,33735,POINT (-87.687011 41.88004),60612-20210113
60612,01/14/2021,100,1800,65,1310,0.039,35,490,0.015,33735,POINT (-87.687011 41.88004),60612-20210114
60601,03/02/2021,45,4007,20,2465,0.163,25,1542,0.102,15083,POINT (-87.622844 41.886262),60601-20210302
60601,03/03/2021,110,4117,41,2506,0.166,69,1611,0.107,15083,POINT (-87.622844 41.886262),60601-20210303
60601,03/04/2021,119,4236,83,2589,0.172,36,1647,0.109,15083,POINT (-87.622844 41.886262),60601-20210304
60602,02/16/2021,11,505,8,359,0.314,3,146,0.128,1145,POINT (-87.628309 41.883136),60602-20210216
60602,02/17/2021,8,513,1,360,0.314,7,153,0.134,1145,POINT (-87.628309 41.883136),60602-20210217
60602,02/18/2021,21,534,8,368,0.321,13,166,0.145,1145,POINT (-87.628309 41.883136),60602-20210218
60602,02/19/2021,14,548,6,374,0.327,8,174,0.152,1145,POINT (-87.628309 41.883136),60602-20210219
60602,02/20/2021,12,560,2,376,0.328,10,184,0.161,1145,POINT (-87.628309 41.883136),60602-20210220
60602,02/21/2021,0,560,0,376,0.328,0,184,0.161,1145,POINT (-87.628309 41.883136),60602-20210221
60602,02/22/2021,11,571,2,378,0.33,9,193,0.169,1145,POINT (-87.628309 41.883136),60602-20210222
60614,01/23/2021,168,6497,149,4794,0.067,19,1703,0.024,71954,POINT (-87.652064 41.922605),60614-20210123
60614,01/24/2021,76,6573,70,4864,0.068,6,1709,0.024,71954,POINT (-87.652064 41.922605),60614-20210124
60614,01/25/2021,345,6918,273,5137,0.071,72,1781,0.025,71954,POINT (-87.652064 41.922605),60614-20210125
60614,01/26/2021,424,7342,236,5373,0.075,188,1969,0.027,71954,POINT (-87.652064 41.922605),60614-20210126
60614,01/27/2021,314,7656,252,5625,0.078,62,2031,0.028,71954,POINT (-87.652064 41.922605),60614-20210127
60614,01/28/2021,413,8069,355,5980,0.083,58,2089,0.029,71954,POINT (-87.652064 41.922605),60614-20210128
60614,01/29/2021,432,8501,394,6374,0.089,38,2127,0.03,71954,POINT (-87.652064 41.922605),60614-20210129
60614,01/30/2021,175,8676,135,6509,0.09,40,2167,0.03,71954,POINT (-87.652064 41.922605),60614-20210130
60614,01/31/2021,79,8755,63,6572,0.091,16,2183,0.03,71954,POINT (-87.652064 41.922605),60614-20210131
60614,02/01/2021,210,8965,150,6722,0.093,60,2243,0.031,71954,POINT (-87.652064 41.922605),60614-20210201
60614,02/02/2021,345,9310,215,6937,0.096,130,2373,0.033,71954,POINT (-87.652064 41.922605),60614-20210202
60622,03/04/2021,358,15281,186,9648,0.181,172,5633,0.106,53294,POINT (-87.681818 41.902762),60622-20210304
60622,03/05/2021,313,15594,190,9838,0.185,123,5756,0.108,53294,POINT (-87.681818 41.902762),60622-20210305
60622,03/06/2021,193,15787,102,9940,0.187,91,5847,0.11,53294,POINT (-87.681818 41.902762),60622-20210306
60623,03/05/2021,647,16086,425,12354,0.152,222,3732,0.046,81283,POINT (-87.717446 41.850321),60623-20210305
60623,03/06/2021,447,16533,339,12693,0.156,108,3840,0.047,81283,POINT (-87.717446 41.850321),60623-20210306
60624,03/06/2021,62,4442,35,3143,0.09,27,1299,0.037,34892,POINT (-87.722735 41.879417),60624-20210306
60625,02/22/2021,298,13247,120,9463,0.119,178,3784,0.048,79444,POINT (-87.701816 41.971155),60625-20210222
60625,02/23/2021,425,13672,217,9680,0.122,208,3992,0.05,79444,POINT (-87.701816 41.971155),60625-20210223
60625,02/24/2021,417,14089,198,9878,0.124,219,4211,0.053,79444,POINT (-87.701816 41.971155),60625-20210224
60625,02/25/2021,456,14545,190,10068,0.127,266,4477,0.056,79444,POINT (-87.701816 41.971155),60625-20210225
60625,02/26/2021,530,15075,275,10343,0.13,255,4732,0.06,79444,POINT (-87.701816 41.971155),60625-20210226
60625,02/27/2021,479,15554,262,10605,0.133,217,4949,0.062,79444,POINT (-87.701816 41.971155),60625-20210227
60625,02/28/2021,191,15745,79,10684,0.134,112,5061,0.064,79444,POINT (-87.701816 41.971155),60625-20210228
60625,03/01/2021,337,16082,146,10830,0.136,191,5252,0.066,79444,POINT (-87.701816 41.971155),60625-20210301
60625,03/02/2021,469,16551,288,11118,0.14,181,5433,0.068,79444,POINT (-87.701816 41.971155),60625-20210302
60625,03/03/2021,567,17118,293,11411,0.144,274,5707,0.072,79444,POINT (-87.701816 41.971155),60625-20210303
60625,03/04/2021,501,17619,244,11655,0.147,257,5964,0.075,79444,POINT (-87.701816 41.971155),60625-20210304
60625,03/05/2021,542,18161,325,11980,0.151,217,6181,0.078,79444,POINT (-87.701816 41.971155),60625-20210305
60625,03/06/2021,305,18466,147,12127,0.153,158,6339,0.08,79444,POINT (-87.701816 41.971155),60625-20210306
60626,02/18/2021,203,8788,114,6082,0.12,89,2706,0.054,50544,POINT (-87.669834 42.009469),60626-20210218
60626,02/19/2021,228,9016,108,6190,0.122,120,2826,0.056,50544,POINT (-87.669834 42.009469),60626-20210219
60626,02/20/2021,114,9130,44,6234,0.123,70,2896,0.057,50544,POINT (-87.669834 42.009469),60626-20210220
60626,02/21/2021,55,9185,23,6257,0.124,32,2928,0.058,50544,POINT (-87.669834 42.009469),60626-20210221
60626,02/22/2021,149,9334,58,6315,0.125,91,3019,0.06,50544,POINT (-87.669834 42.009469),60626-20210222
60626,02/23/2021,246,9580,121,6436,0.127,125,3144,0.062,50544,POINT (-87.669834 42.009469),60626-20210223
60626,02/24/2021,249,9829,112,6548,0.13,137,3281,0.065,50544,POINT (-87.669834 42.009469),60626-20210224
60626,02/25/2021,310,10139,169,6717,0.133,141,3422,0.068,50544,POINT (-87.669834 42.009469),60626-20210225
60626,02/26/2021,283,10422,145,6862,0.136,138,3560,0.07,50544,POINT (-87.669834 42.009469),60626-20210226
60626,02/27/2021,309,10731,206,7068,0.14,103,3663,0.072,50544,POINT (-87.669834 42.009469),60626-20210227
60626,02/28/2021,67,10798,35,7103,0.141,32,3695,0.073,50544,POINT (-87.669834 42.009469),60626-20210228
60626,03/01/2021,180,10978,90,7193,0.142,90,3785,0.075,50544,POINT (-87.669834 42.009469),60626-20210301
60626,03/02/2021,220,11198,120,7313,0.145,100,3885,0.077,50544,POINT (-87.669834 42.009469),60626-20210302
60626,03/03/2021,257,11455,120,7433,0.147,137,4022,0.08,50544,POINT (-87.669834 42.009469),60626-20210303
60626,03/04/2021,310,11765,179,7612,0.151,131,4153,0.082,50544,POINT (-87.669834 42.009469),60626-20210304
60626,03/05/2021,260,12025,156,7768,0.154,104,4257,0.084,50544,POINT (-87.669834 42.009469),60626-20210305
60614,01/11/2021,361,3541,134,2590,0.036,227,951,0.013,71954,POINT (-87.652064 41.922605),60614-20210111
60614,01/12/2021,320,3861,146,2736,0.038,174,1125,0.016,71954,POINT (-87.652064 41.922605),60614-20210112
60614,01/13/2021,237,4098,148,2884,0.04,89,1214,0.017,71954,POINT (-87.652064 41.922605),60614-20210113
60614,01/14/2021,131,4229,95,2979,0.041,36,1250,0.017,71954,POINT (-87.652064 41.922605),60614-20210114
60626,03/06/2021,152,12177,92,7860,0.156,60,4317,0.085,50544,POINT (-87.669834 42.009469),60626-20210306
60628,03/04/2021,343,8999,181,6063,0.094,162,2936,0.046,64254,POINT (-87.621537 41.694192),60628-20210304
60628,03/05/2021,315,9314,193,6256,0.097,122,3058,0.048,64254,POINT (-87.621537 41.694192),60628-20210305
60616,02/06/2021,158,6511,120,5011,0.092,38,1500,0.028,54197,POINT (-87.629531 41.844869),60616-20210206
60616,02/07/2021,53,6564,38,5049,0.093,15,1515,0.028,54197,POINT (-87.629531 41.844869),60616-20210207
60616,02/08/2021,291,6855,203,5252,0.097,88,1603,0.03,54197,POINT (-87.629531 41.844869),60616-20210208
60616,02/09/2021,261,7116,197,5449,0.101,64,1667,0.031,54197,POINT (-87.629531 41.844869),60616-20210209
60616,02/10/2021,350,7466,228,5677,0.105,122,1789,0.033,54197,POINT (-87.629531 41.844869),60616-20210210
60616,02/11/2021,271,7737,150,5827,0.108,121,1910,0.035,54197,POINT (-87.629531 41.844869),60616-20210211
60616,02/12/2021,284,8021,152,5979,0.11,132,2042,0.038,54197,POINT (-87.629531 41.844869),60616-20210212
60616,02/13/2021,217,8238,115,6094,0.112,102,2144,0.04,54197,POINT (-87.629531 41.844869),60616-20210213
60616,02/14/2021,60,8298,45,6139,0.113,15,2159,0.04,54197,POINT (-87.629531 41.844869),60616-20210214
60616,02/15/2021,136,8434,93,6232,0.115,43,2202,0.041,54197,POINT (-87.629531 41.844869),60616-20210215
60614,01/01/2021,3,1801,3,1801,0.025,0,0,0,71954,POINT (-87.652064 41.922605),60614-20210101
60614,01/02/2021,53,1854,53,1854,0.026,0,0,0,71954,POINT (-87.652064 41.922605),60614-20210102
60614,01/03/2021,35,1889,35,1889,0.026,0,0,0,71954,POINT (-87.652064 41.922605),60614-20210103
60614,01/04/2021,101,1990,89,1978,0.027,12,12,0,71954,POINT (-87.652064 41.922605),60614-20210104
60614,01/05/2021,180,2170,171,2149,0.03,9,21,0,71954,POINT (-87.652064 41.922605),60614-20210105
60614,01/06/2021,109,2279,82,2231,0.031,27,48,0.001,71954,POINT (-87.652064 41.922605),60614-20210106
60614,01/07/2021,231,2510,46,2277,0.032,185,233,0.003,71954,POINT (-87.652064 41.922605),60614-20210107
60614,01/08/2021,401,2911,92,2369,0.033,309,542,0.008,71954,POINT (-87.652064 41.922605),60614-20210108
60614,01/09/2021,192,3103,52,2421,0.034,140,682,0.009,71954,POINT (-87.652064 41.922605),60614-20210109
60614,01/10/2021,77,3180,35,2456,0.034,42,724,0.01,71954,POINT (-87.652064 41.922605),60614-20210110
60602,02/23/2021,14,585,3,381,0.333,11,204,0.178,1145,POINT (-87.628309 41.883136),60602-20210223
60602,02/24/2021,16,601,7,388,0.339,9,213,0.186,1145,POINT (-87.628309 41.883136),60602-20210224
60602,02/25/2021,23,624,4,392,0.342,19,232,0.203,1145,POINT (-87.628309 41.883136),60602-20210225
60602,02/26/2021,19,643,6,398,0.348,13,245,0.214,1145,POINT (-87.628309 41.883136),60602-20210226
60628,03/06/2021,206,9520,90,6346,0.099,116,3174,0.049,64254,POINT (-87.621537 41.694192),60628-20210306
60629,02/16/2021,272,9195,242,7643,0.069,30,1552,0.014,110029,POINT (-87.711565 41.777061),60629-20210216
60629,02/17/2021,462,9657,308,7951,0.072,154,1706,0.016,110029,POINT (-87.711565 41.777061),60629-20210217
60629,02/18/2021,441,10098,319,8270,0.075,122,1828,0.017,110029,POINT (-87.711565 41.777061),60629-20210218
60629,02/19/2021,486,10584,306,8576,0.078,180,2008,0.018,110029,POINT (-87.711565 41.777061),60629-20210219
60629,02/20/2021,359,10943,227,8803,0.08,132,2140,0.019,110029,POINT (-87.711565 41.777061),60629-20210220
60629,02/21/2021,52,10995,35,8838,0.08,17,2157,0.02,110029,POINT (-87.711565 41.777061),60629-20210221
60629,02/22/2021,551,11546,422,9260,0.084,129,2286,0.021,110029,POINT (-87.711565 41.777061),60629-20210222
60629,02/23/2021,643,12189,481,9741,0.089,162,2448,0.022,110029,POINT (-87.711565 41.777061),60629-20210223
60629,02/24/2021,619,12808,446,10187,0.093,173,2621,0.024,110029,POINT (-87.711565 41.777061),60629-20210224
60629,02/25/2021,825,13633,551,10738,0.098,274,2895,0.026,110029,POINT (-87.711565 41.777061),60629-20210225
60629,02/26/2021,1008,14641,716,11454,0.104,292,3187,0.029,110029,POINT (-87.711565 41.777061),60629-20210226
60629,02/27/2021,778,15419,619,12073,0.11,159,3346,0.03,110029,POINT (-87.711565 41.777061),60629-20210227
60629,02/28/2021,114,15533,74,12147,0.11,40,3386,0.031,110029,POINT (-87.711565 41.777061),60629-20210228
60629,03/01/2021,741,16274,563,12710,0.116,178,3564,0.032,110029,POINT (-87.711565 41.777061),60629-20210301
60629,03/02/2021,824,17098,599,13309,0.121,225,3789,0.034,110029,POINT (-87.711565 41.777061),60629-20210302
60617,02/05/2021,363,4915,268,4190,0.05,95,725,0.009,83553,POINT (-87.556897 41.721257),60617-20210205
60629,03/03/2021,715,17813,437,13746,0.125,278,4067,0.037,110029,POINT (-87.711565 41.777061),60629-20210303
60629,03/04/2021,750,18563,494,14240,0.129,256,4323,0.039,110029,POINT (-87.711565 41.777061),60629-20210304
60629,03/05/2021,877,19440,563,14803,0.135,314,4637,0.042,110029,POINT (-87.711565 41.777061),60629-20210305
60629,03/06/2021,608,20048,394,15197,0.138,214,4851,0.044,110029,POINT (-87.711565 41.777061),60629-20210306
60630,02/25/2021,399,10252,171,7240,0.128,228,3012,0.053,56433,POINT (-87.759611 41.971261),60630-20210225
60630,02/26/2021,455,10707,248,7488,0.133,207,3219,0.057,56433,POINT (-87.759611 41.971261),60630-20210226
60630,02/27/2021,307,11014,151,7639,0.135,156,3375,0.06,56433,POINT (-87.759611 41.971261),60630-20210227
60630,02/28/2021,102,11116,43,7682,0.136,59,3434,0.061,56433,POINT (-87.759611 41.971261),60630-20210228
60630,03/01/2021,285,11401,167,7849,0.139,118,3552,0.063,56433,POINT (-87.759611 41.971261),60630-20210301
60630,03/02/2021,381,11782,209,8058,0.143,172,3724,0.066,56433,POINT (-87.759611 41.971261),60630-20210302
60630,03/03/2021,405,12187,183,8241,0.146,222,3946,0.07,56433,POINT (-87.759611 41.971261),60630-20210303
60630,03/04/2021,399,12586,176,8417,0.149,223,4169,0.074,56433,POINT (-87.759611 41.971261),60630-20210304
60630,03/05/2021,383,12969,219,8636,0.153,164,4333,0.077,56433,POINT (-87.759611 41.971261),60630-20210305
60630,03/06/2021,260,13229,121,8757,0.155,139,4472,0.079,56433,POINT (-87.759611 41.971261),60630-20210306
60631,02/13/2021,227,6272,126,4865,0.165,101,1407,0.048,29529,POINT (-87.813371 41.995019),60631-20210213
60631,02/14/2021,64,6336,53,4918,0.167,11,1418,0.048,29529,POINT (-87.813371 41.995019),60631-20210214
60631,02/15/2021,115,6451,84,5002,0.169,31,1449,0.049,29529,POINT (-87.813371 41.995019),60631-20210215
60631,02/16/2021,149,6600,105,5107,0.173,44,1493,0.051,29529,POINT (-87.813371 41.995019),60631-20210216
60631,02/17/2021,243,6843,111,5218,0.177,132,1625,0.055,29529,POINT (-87.813371 41.995019),60631-20210217
60631,02/18/2021,252,7095,109,5327,0.18,143,1768,0.06,29529,POINT (-87.813371 41.995019),60631-20210218
60631,02/19/2021,232,7327,112,5439,0.184,120,1888,0.064,29529,POINT (-87.813371 41.995019),60631-20210219
60631,02/20/2021,158,7485,77,5516,0.187,81,1969,0.067,29529,POINT (-87.813371 41.995019),60631-20210220
60631,02/21/2021,54,7539,22,5538,0.188,32,2001,0.068,29529,POINT (-87.813371 41.995019),60631-20210221
60631,02/22/2021,142,7681,53,5591,0.189,89,2090,0.071,29529,POINT (-87.813371 41.995019),60631-20210222
60631,02/23/2021,207,7888,81,5672,0.192,126,2216,0.075,29529,POINT (-87.813371 41.995019),60631-20210223
60631,02/24/2021,272,8160,97,5769,0.195,175,2391,0.081,29529,POINT (-87.813371 41.995019),60631-20210224
60631,02/25/2021,259,8419,102,5871,0.199,157,2548,0.086,29529,POINT (-87.813371 41.995019),60631-20210225
60618,01/30/2021,212,7323,160,5589,0.059,52,1734,0.018,94907,POINT (-87.703343 41.946699),60618-20210130
60618,01/31/2021,101,7424,81,5670,0.06,20,1754,0.018,94907,POINT (-87.703343 41.946699),60618-20210131
60618,02/01/2021,269,7693,186,5856,0.062,83,1837,0.019,94907,POINT (-87.703343 41.946699),60618-20210201
60615,12/15/2020,1,1,1,1,0,0,0,0,40590,POINT (-87.602725 41.801993),60615-20201215
60615,12/16/2020,1,2,1,2,0,0,0,0,40590,POINT (-87.602725 41.801993),60615-20201216
60615,12/17/2020,26,28,26,28,0.001,0,0,0,40590,POINT (-87.602725 41.801993),60615-20201217
60615,12/18/2020,95,123,95,123,0.003,0,0,0,40590,POINT (-87.602725 41.801993),60615-20201218
60615,12/19/2020,52,175,52,175,0.004,0,0,0,40590,POINT (-87.602725 41.801993),60615-20201219
60615,12/20/2020,49,224,49,224,0.006,0,0,0,40590,POINT (-87.602725 41.801993),60615-20201220
60615,12/21/2020,45,269,45,269,0.007,0,0,0,40590,POINT (-87.602725 41.801993),60615-20201221
60615,12/22/2020,130,399,130,399,0.01,0,0,0,40590,POINT (-87.602725 41.801993),60615-20201222
60615,12/23/2020,167,566,167,566,0.014,0,0,0,40590,POINT (-87.602725 41.801993),60615-20201223
60615,12/24/2020,60,626,60,626,0.015,0,0,0,40590,POINT (-87.602725 41.801993),60615-20201224
60615,12/25/2020,0,626,0,626,0.015,0,0,0,40590,POINT (-87.602725 41.801993),60615-20201225
60615,12/26/2020,7,633,7,633,0.016,0,0,0,40590,POINT (-87.602725 41.801993),60615-20201226
60615,12/27/2020,0,633,0,633,0.016,0,0,0,40590,POINT (-87.602725 41.801993),60615-20201227
60615,12/28/2020,24,657,24,657,0.016,0,0,0,40590,POINT (-87.602725 41.801993),60615-20201228
60615,12/29/2020,120,777,120,777,0.019,0,0,0,40590,POINT (-87.602725 41.801993),60615-20201229
60615,12/30/2020,229,1006,229,1006,0.025,0,0,0,40590,POINT (-87.602725 41.801993),60615-20201230
60615,12/31/2020,115,1121,115,1121,0.028,0,0,0,40590,POINT (-87.602725 41.801993),60615-20201231
60615,01/01/2021,0,1121,0,1121,0.028,0,0,0,40590,POINT (-87.602725 41.801993),60615-20210101
60615,01/02/2021,3,1124,3,1124,0.028,0,0,0,40590,POINT (-87.602725 41.801993),60615-20210102
60615,01/03/2021,156,1280,150,1274,0.031,6,6,0,40590,POINT (-87.602725 41.801993),60615-20210103
60615,01/04/2021,169,1449,156,1430,0.035,13,19,0,40590,POINT (-87.602725 41.801993),60615-20210104
60615,01/05/2021,58,1507,36,1466,0.036,22,41,0.001,40590,POINT (-87.602725 41.801993),60615-20210105
60615,01/06/2021,100,1607,78,1544,0.038,22,63,0.002,40590,POINT (-87.602725 41.801993),60615-20210106
60615,01/07/2021,115,1722,68,1612,0.04,47,110,0.003,40590,POINT (-87.602725 41.801993),60615-20210107
60615,01/08/2021,157,1879,75,1687,0.042,82,192,0.005,40590,POINT (-87.602725 41.801993),60615-20210108
60615,01/09/2021,106,1985,25,1712,0.042,81,273,0.007,40590,POINT (-87.602725 41.801993),60615-20210109
60615,01/10/2021,86,2071,10,1722,0.042,76,349,0.009,40590,POINT (-87.602725 41.801993),60615-20210110
60615,01/11/2021,104,2175,25,1747,0.043,79,428,0.011,40590,POINT (-87.602725 41.801993),60615-20210111
60615,01/12/2021,128,2303,54,1801,0.044,74,502,0.012,40590,POINT (-87.602725 41.801993),60615-20210112
60615,01/13/2021,129,2432,50,1851,0.046,79,581,0.014,40590,POINT (-87.602725 41.801993),60615-20210113
60615,01/14/2021,75,2507,56,1907,0.047,19,600,0.015,40590,POINT (-87.602725 41.801993),60615-20210114
60615,01/15/2021,93,2600,58,1965,0.048,35,635,0.016,40590,POINT (-87.602725 41.801993),60615-20210115
60615,01/16/2021,132,2732,33,1998,0.049,99,734,0.018,40590,POINT (-87.602725 41.801993),60615-20210116
60615,01/17/2021,83,2815,15,2013,0.05,68,802,0.02,40590,POINT (-87.602725 41.801993),60615-20210117
60615,01/18/2021,264,3079,198,2211,0.054,66,868,0.021,40590,POINT (-87.602725 41.801993),60615-20210118
60615,01/19/2021,247,3326,182,2393,0.059,65,933,0.023,40590,POINT (-87.602725 41.801993),60615-20210119
60615,01/20/2021,281,3607,162,2555,0.063,119,1052,0.026,40590,POINT (-87.602725 41.801993),60615-20210120
60615,01/21/2021,438,4045,337,2892,0.071,101,1153,0.028,40590,POINT (-87.602725 41.801993),60615-20210121
60615,01/22/2021,339,4384,259,3151,0.078,80,1233,0.03,40590,POINT (-87.602725 41.801993),60615-20210122
60615,01/23/2021,210,4594,124,3275,0.081,86,1319,0.032,40590,POINT (-87.602725 41.801993),60615-20210123
60615,01/24/2021,77,4671,75,3350,0.083,2,1321,0.033,40590,POINT (-87.602725 41.801993),60615-20210124
60615,01/25/2021,192,4863,110,3460,0.085,82,1403,0.035,40590,POINT (-87.602725 41.801993),60615-20210125
60615,01/26/2021,157,5020,111,3571,0.088,46,1449,0.036,40590,POINT (-87.602725 41.801993),60615-20210126
60615,01/27/2021,203,5223,163,3734,0.092,40,1489,0.037,40590,POINT (-87.602725 41.801993),60615-20210127
60615,01/28/2021,224,5447,172,3906,0.096,52,1541,0.038,40590,POINT (-87.602725 41.801993),60615-20210128
60615,01/29/2021,270,5717,222,4128,0.102,48,1589,0.039,40590,POINT (-87.602725 41.801993),60615-20210129
60615,01/30/2021,113,5830,87,4215,0.104,26,1615,0.04,40590,POINT (-87.602725 41.801993),60615-20210130
60615,01/31/2021,99,5929,98,4313,0.106,1,1616,0.04,40590,POINT (-87.602725 41.801993),60615-20210131
60615,02/01/2021,115,6044,79,4392,0.108,36,1652,0.041,40590,POINT (-87.602725 41.801993),60615-20210201
60615,02/02/2021,153,6197,96,4488,0.111,57,1709,0.042,40590,POINT (-87.602725 41.801993),60615-20210202
60618,02/02/2021,449,8142,308,6164,0.065,141,1978,0.021,94907,POINT (-87.703343 41.946699),60618-20210202
60618,02/03/2021,441,8583,337,6501,0.068,104,2082,0.022,94907,POINT (-87.703343 41.946699),60618-20210203
60618,02/04/2021,499,9082,405,6906,0.073,94,2176,0.023,94907,POINT (-87.703343 41.946699),60618-20210204
60618,02/05/2021,492,9574,389,7295,0.077,103,2279,0.024,94907,POINT (-87.703343 41.946699),60618-20210205
60618,02/06/2021,377,9951,282,7577,0.08,95,2374,0.025,94907,POINT (-87.703343 41.946699),60618-20210206
60618,02/07/2021,101,10052,88,7665,0.081,13,2387,0.025,94907,POINT (-87.703343 41.946699),60618-20210207
60618,02/08/2021,305,10357,245,7910,0.083,60,2447,0.026,94907,POINT (-87.703343 41.946699),60618-20210208
60631,02/26/2021,305,8724,138,6009,0.203,167,2715,0.092,29529,POINT (-87.813371 41.995019),60631-20210226
60631,02/27/2021,221,8945,99,6108,0.207,122,2837,0.096,29529,POINT (-87.813371 41.995019),60631-20210227
60631,02/28/2021,78,9023,39,6147,0.208,39,2876,0.097,29529,POINT (-87.813371 41.995019),60631-20210228
60631,03/01/2021,189,9212,103,6250,0.212,86,2962,0.1,29529,POINT (-87.813371 41.995019),60631-20210301
60631,03/02/2021,224,9436,101,6351,0.215,123,3085,0.104,29529,POINT (-87.813371 41.995019),60631-20210302
60631,03/03/2021,252,9688,92,6443,0.218,160,3245,0.11,29529,POINT (-87.813371 41.995019),60631-20210303
60631,03/04/2021,263,9951,129,6572,0.223,134,3379,0.114,29529,POINT (-87.813371 41.995019),60631-20210304
60631,03/05/2021,257,10208,134,6706,0.227,123,3502,0.119,29529,POINT (-87.813371 41.995019),60631-20210305
60631,03/06/2021,189,10397,59,6765,0.229,130,3632,0.123,29529,POINT (-87.813371 41.995019),60631-20210306
60632,02/03/2021,386,3933,350,3344,0.037,36,589,0.007,89857,POINT (-87.711251 41.810038),60632-20210203
60632,02/04/2021,424,4357,376,3720,0.041,48,637,0.007,89857,POINT (-87.711251 41.810038),60632-20210204
60632,02/05/2021,416,4773,383,4103,0.046,33,670,0.007,89857,POINT (-87.711251 41.810038),60632-20210205
60632,02/06/2021,281,5054,237,4340,0.048,44,714,0.008,89857,POINT (-87.711251 41.810038),60632-20210206
60632,02/07/2021,26,5080,23,4363,0.049,3,717,0.008,89857,POINT (-87.711251 41.810038),60632-20210207
60632,02/08/2021,302,5382,278,4641,0.052,24,741,0.008,89857,POINT (-87.711251 41.810038),60632-20210208
60632,02/09/2021,362,5744,316,4957,0.055,46,787,0.009,89857,POINT (-87.711251 41.810038),60632-20210209
60632,02/10/2021,426,6170,368,5325,0.059,58,845,0.009,89857,POINT (-87.711251 41.810038),60632-20210210
60632,02/11/2021,496,6666,405,5730,0.064,91,936,0.01,89857,POINT (-87.711251 41.810038),60632-20210211
60632,02/12/2021,432,7098,361,6091,0.068,71,1007,0.011,89857,POINT (-87.711251 41.810038),60632-20210212
60632,02/13/2021,281,7379,225,6316,0.07,56,1063,0.012,89857,POINT (-87.711251 41.810038),60632-20210213
60632,02/14/2021,39,7418,26,6342,0.071,13,1076,0.012,89857,POINT (-87.711251 41.810038),60632-20210214
60632,02/15/2021,363,7781,329,6671,0.074,34,1110,0.012,89857,POINT (-87.711251 41.810038),60632-20210215
60632,02/16/2021,316,8097,279,6950,0.077,37,1147,0.013,89857,POINT (-87.711251 41.810038),60632-20210216
60632,02/17/2021,342,8439,229,7179,0.08,113,1260,0.014,89857,POINT (-87.711251 41.810038),60632-20210217
60632,02/18/2021,415,8854,303,7482,0.083,112,1372,0.015,89857,POINT (-87.711251 41.810038),60632-20210218
60632,02/19/2021,368,9222,233,7715,0.086,135,1507,0.017,89857,POINT (-87.711251 41.810038),60632-20210219
60632,02/20/2021,368,9590,254,7969,0.089,114,1621,0.018,89857,POINT (-87.711251 41.810038),60632-20210220
60632,02/21/2021,32,9622,16,7985,0.089,16,1637,0.018,89857,POINT (-87.711251 41.810038),60632-20210221
60632,02/22/2021,467,10089,342,8327,0.093,125,1762,0.02,89857,POINT (-87.711251 41.810038),60632-20210222
60632,02/23/2021,550,10639,399,8726,0.097,151,1913,0.021,89857,POINT (-87.711251 41.810038),60632-20210223
60632,02/24/2021,630,11269,429,9155,0.102,201,2114,0.024,89857,POINT (-87.711251 41.810038),60632-20210224
60632,02/25/2021,731,12000,501,9656,0.107,230,2344,0.026,89857,POINT (-87.711251 41.810038),60632-20210225
60632,02/26/2021,766,12766,482,10138,0.113,284,2628,0.029,89857,POINT (-87.711251 41.810038),60632-20210226
60632,02/27/2021,667,13433,533,10671,0.119,134,2762,0.031,89857,POINT (-87.711251 41.810038),60632-20210227
60632,02/28/2021,74,13507,54,10725,0.119,20,2782,0.031,89857,POINT (-87.711251 41.810038),60632-20210228
60632,03/01/2021,556,14063,385,11110,0.124,171,2953,0.033,89857,POINT (-87.711251 41.810038),60632-20210301
60632,03/02/2021,727,14790,464,11574,0.129,263,3216,0.036,89857,POINT (-87.711251 41.810038),60632-20210302
60632,03/03/2021,697,15487,359,11933,0.133,338,3554,0.04,89857,POINT (-87.711251 41.810038),60632-20210303
60632,03/05/2021,742,16928,468,12786,0.142,274,4142,0.046,89857,POINT (-87.711251 41.810038),60632-20210305
60632,03/06/2021,491,17419,305,13091,0.146,186,4328,0.048,89857,POINT (-87.711251 41.810038),60632-20210306
60633,03/05/2021,66,1634,42,1097,0.086,24,537,0.042,12689,POINT (-87.556037 41.653147),60633-20210305
60633,03/06/2021,32,1666,10,1107,0.087,22,559,0.044,12689,POINT (-87.556037 41.653147),60633-20210306
60634,02/19/2021,350,11168,164,8263,0.11,186,2905,0.039,75082,POINT (-87.797373 41.944967),60634-20210219
60634,02/20/2021,253,11421,164,8427,0.112,89,2994,0.04,75082,POINT (-87.797373 41.944967),60634-20210220
60634,02/21/2021,91,11512,61,8488,0.113,30,3024,0.04,75082,POINT (-87.797373 41.944967),60634-20210221
60620,02/01/2021,154,2423,139,2040,0.03,15,383,0.006,67711,POINT (-87.651656 41.740873),60620-20210201
60634,02/22/2021,218,11730,101,8589,0.114,117,3141,0.042,75082,POINT (-87.797373 41.944967),60634-20210222
60634,02/23/2021,372,12102,214,8803,0.117,158,3299,0.044,75082,POINT (-87.797373 41.944967),60634-20210223
60634,02/24/2021,396,12498,216,9019,0.12,180,3479,0.046,75082,POINT (-87.797373 41.944967),60634-20210224
60634,02/25/2021,551,13049,254,9273,0.124,297,3776,0.05,75082,POINT (-87.797373 41.944967),60634-20210225
60634,02/26/2021,514,13563,263,9536,0.127,251,4027,0.054,75082,POINT (-87.797373 41.944967),60634-20210226
60634,02/27/2021,552,14115,356,9892,0.132,196,4223,0.056,75082,POINT (-87.797373 41.944967),60634-20210227
60634,02/28/2021,254,14369,173,10065,0.134,81,4304,0.057,75082,POINT (-87.797373 41.944967),60634-20210228
60634,03/01/2021,287,14656,158,10223,0.136,129,4433,0.059,75082,POINT (-87.797373 41.944967),60634-20210301
60634,03/02/2021,456,15112,221,10444,0.139,235,4668,0.062,75082,POINT (-87.797373 41.944967),60634-20210302
60634,03/03/2021,549,15661,297,10741,0.143,252,4920,0.066,75082,POINT (-87.797373 41.944967),60634-20210303
60634,03/04/2021,478,16139,241,10982,0.146,237,5157,0.069,75082,POINT (-87.797373 41.944967),60634-20210304
60634,03/05/2021,510,16649,291,11273,0.15,219,5376,0.072,75082,POINT (-87.797373 41.944967),60634-20210305
60634,03/06/2021,375,17024,163,11436,0.152,212,5588,0.074,75082,POINT (-87.797373 41.944967),60634-20210306
60636,02/06/2021,33,1191,29,1030,0.034,4,161,0.005,30024,POINT (-87.668597 41.77599),60636-20210206
60636,02/07/2021,16,1207,16,1046,0.035,0,161,0.005,30024,POINT (-87.668597 41.77599),60636-20210207
60636,02/08/2021,67,1274,54,1100,0.037,13,174,0.006,30024,POINT (-87.668597 41.77599),60636-20210208
60636,02/09/2021,80,1354,66,1166,0.039,14,188,0.006,30024,POINT (-87.668597 41.77599),60636-20210209
60636,02/10/2021,97,1451,80,1246,0.042,17,205,0.007,30024,POINT (-87.668597 41.77599),60636-20210210
60636,02/11/2021,106,1557,72,1318,0.044,34,239,0.008,30024,POINT (-87.668597 41.77599),60636-20210211
60636,02/12/2021,73,1630,58,1376,0.046,15,254,0.008,30024,POINT (-87.668597 41.77599),60636-20210212
60636,02/13/2021,75,1705,62,1438,0.048,13,267,0.009,30024,POINT (-87.668597 41.77599),60636-20210213
60636,02/14/2021,6,1711,5,1443,0.048,1,268,0.009,30024,POINT (-87.668597 41.77599),60636-20210214
60636,02/15/2021,53,1764,38,1481,0.049,15,283,0.009,30024,POINT (-87.668597 41.77599),60636-20210215
60636,02/16/2021,91,1855,38,1519,0.051,53,336,0.011,30024,POINT (-87.668597 41.77599),60636-20210216
60636,02/17/2021,89,1944,51,1570,0.052,38,374,0.012,30024,POINT (-87.668597 41.77599),60636-20210217
60618,01/28/2021,497,6743,424,5109,0.054,73,1634,0.017,94907,POINT (-87.703343 41.946699),60618-20210128
60618,01/29/2021,368,7111,320,5429,0.057,48,1682,0.018,94907,POINT (-87.703343 41.946699),60618-20210129
60618,01/14/2021,171,3471,132,2596,0.027,39,875,0.009,94907,POINT (-87.703343 41.946699),60618-20210114
60618,01/15/2021,136,3607,122,2718,0.029,14,889,0.009,94907,POINT (-87.703343 41.946699),60618-20210115
60618,01/16/2021,111,3718,94,2812,0.03,17,906,0.01,94907,POINT (-87.703343 41.946699),60618-20210116
60618,01/17/2021,54,3772,32,2844,0.03,22,928,0.01,94907,POINT (-87.703343 41.946699),60618-20210117
60618,01/18/2021,144,3916,83,2927,0.031,61,989,0.01,94907,POINT (-87.703343 41.946699),60618-20210118
60618,01/19/2021,195,4111,100,3027,0.032,95,1084,0.011,94907,POINT (-87.703343 41.946699),60618-20210119
60618,01/20/2021,300,4411,187,3214,0.034,113,1197,0.013,94907,POINT (-87.703343 41.946699),60618-20210120
60618,01/21/2021,324,4735,251,3465,0.037,73,1270,0.013,94907,POINT (-87.703343 41.946699),60618-20210121
60618,01/22/2021,302,5037,271,3736,0.039,31,1301,0.014,94907,POINT (-87.703343 41.946699),60618-20210122
60618,01/23/2021,152,5189,137,3873,0.041,15,1316,0.014,94907,POINT (-87.703343 41.946699),60618-20210123
60618,01/24/2021,59,5248,56,3929,0.041,3,1319,0.014,94907,POINT (-87.703343 41.946699),60618-20210124
60618,01/25/2021,288,5536,225,4154,0.044,63,1382,0.015,94907,POINT (-87.703343 41.946699),60618-20210125
60618,01/26/2021,351,5887,254,4408,0.046,97,1479,0.016,94907,POINT (-87.703343 41.946699),60618-20210126
60618,01/27/2021,359,6246,277,4685,0.049,82,1561,0.016,94907,POINT (-87.703343 41.946699),60618-20210127
60602,02/27/2021,10,653,6,404,0.353,4,249,0.217,1145,POINT (-87.628309 41.883136),60602-20210227
60602,02/28/2021,2,655,0,404,0.353,2,251,0.219,1145,POINT (-87.628309 41.883136),60602-20210228
60636,02/18/2021,93,2037,48,1618,0.054,45,419,0.014,30024,POINT (-87.668597 41.77599),60636-20210218
60636,02/19/2021,116,2153,64,1682,0.056,52,471,0.016,30024,POINT (-87.668597 41.77599),60636-20210219
60636,02/20/2021,58,2211,42,1724,0.057,16,487,0.016,30024,POINT (-87.668597 41.77599),60636-20210220
60636,02/21/2021,21,2232,16,1740,0.058,5,492,0.016,30024,POINT (-87.668597 41.77599),60636-20210221
60636,02/22/2021,103,2335,58,1798,0.06,45,537,0.018,30024,POINT (-87.668597 41.77599),60636-20210222
60621,02/12/2021,64,1606,38,1303,0.047,26,303,0.011,28018,POINT (-87.638812 41.776931),60621-20210212
60621,02/13/2021,63,1669,41,1344,0.048,22,325,0.012,28018,POINT (-87.638812 41.776931),60621-20210213
60621,02/14/2021,12,1681,11,1355,0.048,1,326,0.012,28018,POINT (-87.638812 41.776931),60621-20210214
60621,02/15/2021,84,1765,44,1399,0.05,40,366,0.013,28018,POINT (-87.638812 41.776931),60621-20210215
60636,02/23/2021,90,2425,55,1853,0.062,35,572,0.019,30024,POINT (-87.668597 41.77599),60636-20210223
60636,02/24/2021,89,2514,50,1903,0.063,39,611,0.02,30024,POINT (-87.668597 41.77599),60636-20210224
60636,02/25/2021,121,2635,64,1967,0.066,57,668,0.022,30024,POINT (-87.668597 41.77599),60636-20210225
60636,02/26/2021,136,2771,91,2058,0.069,45,713,0.024,30024,POINT (-87.668597 41.77599),60636-20210226
60636,02/27/2021,83,2854,67,2125,0.071,16,729,0.024,30024,POINT (-87.668597 41.77599),60636-20210227
60636,02/28/2021,25,2879,11,2136,0.071,14,743,0.025,30024,POINT (-87.668597 41.77599),60636-20210228
60636,03/01/2021,140,3019,84,2220,0.074,56,799,0.027,30024,POINT (-87.668597 41.77599),60636-20210301
60636,03/02/2021,175,3194,120,2340,0.078,55,854,0.028,30024,POINT (-87.668597 41.77599),60636-20210302
60636,03/03/2021,130,3324,73,2413,0.08,57,911,0.03,30024,POINT (-87.668597 41.77599),60636-20210303
60636,03/04/2021,133,3457,83,2496,0.083,50,961,0.032,30024,POINT (-87.668597 41.77599),60636-20210304
60636,03/05/2021,181,3638,131,2627,0.087,50,1011,0.034,30024,POINT (-87.668597 41.77599),60636-20210305
60636,03/06/2021,81,3719,42,2669,0.089,39,1050,0.035,30024,POINT (-87.668597 41.77599),60636-20210306
60637,02/27/2021,111,7826,73,4787,0.101,38,3039,0.064,47300,POINT (-87.604053 41.780991),60637-20210227
60637,02/28/2021,102,7928,28,4815,0.102,74,3113,0.066,47300,POINT (-87.604053 41.780991),60637-20210228
60637,03/01/2021,130,8058,86,4901,0.104,44,3157,0.067,47300,POINT (-87.604053 41.780991),60637-20210301
60637,03/02/2021,119,8177,69,4970,0.105,50,3207,0.068,47300,POINT (-87.604053 41.780991),60637-20210302
60637,03/03/2021,199,8376,110,5080,0.107,89,3296,0.07,47300,POINT (-87.604053 41.780991),60637-20210303
60637,03/04/2021,150,8526,89,5169,0.109,61,3357,0.071,47300,POINT (-87.604053 41.780991),60637-20210304
60637,03/05/2021,189,8715,126,5295,0.112,63,3420,0.072,47300,POINT (-87.604053 41.780991),60637-20210305
60637,03/06/2021,95,8810,47,5342,0.113,48,3468,0.073,47300,POINT (-87.604053 41.780991),60637-20210306
60638,02/14/2021,40,6759,25,5429,0.093,15,1330,0.023,58669,POINT (-87.771902 41.787032),60638-20210214
60638,02/15/2021,217,6976,170,5599,0.095,47,1377,0.023,58669,POINT (-87.771902 41.787032),60638-20210215
60638,02/16/2021,201,7177,149,5748,0.098,52,1429,0.024,58669,POINT (-87.771902 41.787032),60638-20210216
60619,01/21/2021,184,1372,154,1161,0.019,30,211,0.003,61207,POINT (-87.60569 41.744737),60619-20210121
60619,01/22/2021,260,1632,251,1412,0.023,9,220,0.004,61207,POINT (-87.60569 41.744737),60619-20210122
60619,01/23/2021,101,1733,98,1510,0.025,3,223,0.004,61207,POINT (-87.60569 41.744737),60619-20210123
60619,01/24/2021,30,1763,28,1538,0.025,2,225,0.004,61207,POINT (-87.60569 41.744737),60619-20210124
60619,01/25/2021,147,1910,129,1667,0.027,18,243,0.004,61207,POINT (-87.60569 41.744737),60619-20210125
60619,01/26/2021,165,2075,133,1800,0.029,32,275,0.004,61207,POINT (-87.60569 41.744737),60619-20210126
60619,01/27/2021,194,2269,171,1971,0.032,23,298,0.005,61207,POINT (-87.60569 41.744737),60619-20210127
60619,01/28/2021,219,2488,201,2172,0.035,18,316,0.005,61207,POINT (-87.60569 41.744737),60619-20210128
60619,01/29/2021,300,2788,278,2450,0.04,22,338,0.006,61207,POINT (-87.60569 41.744737),60619-20210129
60619,01/30/2021,109,2897,97,2547,0.042,12,350,0.006,61207,POINT (-87.60569 41.744737),60619-20210130
60619,01/31/2021,15,2912,14,2561,0.042,1,351,0.006,61207,POINT (-87.60569 41.744737),60619-20210131
60638,02/17/2021,271,7448,136,5884,0.1,135,1564,0.027,58669,POINT (-87.771902 41.787032),60638-20210217
60638,02/18/2021,345,7793,191,6075,0.104,154,1718,0.029,58669,POINT (-87.771902 41.787032),60638-20210218
60638,02/19/2021,375,8168,194,6269,0.107,181,1899,0.032,58669,POINT (-87.771902 41.787032),60638-20210219
60638,02/20/2021,219,8387,99,6368,0.109,120,2019,0.034,58669,POINT (-87.771902 41.787032),60638-20210220
60638,02/21/2021,55,8442,33,6401,0.109,22,2041,0.035,58669,POINT (-87.771902 41.787032),60638-20210221
60638,02/22/2021,251,8693,104,6505,0.111,147,2188,0.037,58669,POINT (-87.771902 41.787032),60638-20210222
60638,02/23/2021,353,9046,160,6665,0.114,193,2381,0.041,58669,POINT (-87.771902 41.787032),60638-20210223
60638,02/24/2021,383,9429,195,6860,0.117,188,2569,0.044,58669,POINT (-87.771902 41.787032),60638-20210224
60638,02/25/2021,429,9858,201,7061,0.12,228,2797,0.048,58669,POINT (-87.771902 41.787032),60638-20210225
60638,02/26/2021,489,10347,234,7295,0.124,255,3052,0.052,58669,POINT (-87.771902 41.787032),60638-20210226
60638,02/27/2021,322,10669,188,7483,0.128,134,3186,0.054,58669,POINT (-87.771902 41.787032),60638-20210227
60638,02/28/2021,96,10765,51,7534,0.128,45,3231,0.055,58669,POINT (-87.771902 41.787032),60638-20210228
60638,03/01/2021,285,11050,168,7702,0.131,117,3348,0.057,58669,POINT (-87.771902 41.787032),60638-20210301
60638,03/02/2021,352,11402,160,7862,0.134,192,3540,0.06,58669,POINT (-87.771902 41.787032),60638-20210302
60638,03/03/2021,388,11790,161,8023,0.137,227,3767,0.064,58669,POINT (-87.771902 41.787032),60638-20210303
60638,03/04/2021,378,12168,180,8203,0.14,198,3965,0.068,58669,POINT (-87.771902 41.787032),60638-20210304
60638,03/05/2021,365,12533,189,8392,0.143,176,4141,0.071,58669,POINT (-87.771902 41.787032),60638-20210305
60638,03/06/2021,204,12737,102,8494,0.145,102,4243,0.072,58669,POINT (-87.771902 41.787032),60638-20210306
60639,02/16/2021,146,8300,102,6891,0.078,44,1409,0.016,88204,POINT (-87.75531 41.920609),60639-20210216
60639,02/17/2021,242,8542,110,7001,0.079,132,1541,0.017,88204,POINT (-87.75531 41.920609),60639-20210217
60639,02/18/2021,273,8815,144,7145,0.081,129,1670,0.019,88204,POINT (-87.75531 41.920609),60639-20210218
60639,02/19/2021,297,9112,128,7273,0.082,169,1839,0.021,88204,POINT (-87.75531 41.920609),60639-20210219
60639,02/20/2021,1118,10230,1053,8326,0.094,65,1904,0.022,88204,POINT (-87.75531 41.920609),60639-20210220
60639,02/21/2021,738,10968,720,9046,0.103,18,1922,0.022,88204,POINT (-87.75531 41.920609),60639-20210221
60639,02/22/2021,172,11140,76,9122,0.103,96,2018,0.023,88204,POINT (-87.75531 41.920609),60639-20210222
60639,02/23/2021,296,11436,183,9305,0.105,113,2131,0.024,88204,POINT (-87.75531 41.920609),60639-20210223
60639,02/24/2021,252,11688,150,9455,0.107,102,2233,0.025,88204,POINT (-87.75531 41.920609),60639-20210224
60639,02/25/2021,301,11989,146,9601,0.109,155,2388,0.027,88204,POINT (-87.75531 41.920609),60639-20210225
60639,02/26/2021,306,12295,117,9718,0.11,189,2577,0.029,88204,POINT (-87.75531 41.920609),60639-20210226
60639,02/27/2021,1304,13599,1187,10905,0.124,117,2694,0.031,88204,POINT (-87.75531 41.920609),60639-20210227
60620,01/15/2021,40,878,36,744,0.011,4,134,0.002,67711,POINT (-87.651656 41.740873),60620-20210115
60620,01/16/2021,21,899,18,762,0.011,3,137,0.002,67711,POINT (-87.651656 41.740873),60620-20210116
60620,01/17/2021,4,903,3,765,0.011,1,138,0.002,67711,POINT (-87.651656 41.740873),60620-20210117
60620,01/18/2021,36,939,27,792,0.012,9,147,0.002,67711,POINT (-87.651656 41.740873),60620-20210118
60639,02/28/2021,791,14390,749,11654,0.132,42,2736,0.031,88204,POINT (-87.75531 41.920609),60639-20210228
60623,02/05/2021,398,4513,343,3784,0.047,55,729,0.009,81283,POINT (-87.717446 41.850321),60623-20210205
60639,03/01/2021,293,14683,144,11798,0.134,149,2885,0.033,88204,POINT (-87.75531 41.920609),60639-20210301
60639,03/02/2021,349,15032,187,11985,0.136,162,3047,0.035,88204,POINT (-87.75531 41.920609),60639-20210302
60639,03/03/2021,427,15459,185,12170,0.138,242,3289,0.037,88204,POINT (-87.75531 41.920609),60639-20210303
60639,03/05/2021,406,16275,232,12619,0.143,174,3656,0.041,88204,POINT (-87.75531 41.920609),60639-20210305
60639,03/06/2021,368,16643,138,12757,0.145,230,3886,0.044,88204,POINT (-87.75531 41.920609),60639-20210306
60640,02/18/2021,650,15095,272,10746,0.155,378,4349,0.063,69363,POINT (-87.662232 41.971888),60640-20210218
60640,02/19/2021,380,15475,179,10925,0.158,201,4550,0.066,69363,POINT (-87.662232 41.971888),60640-20210219
60640,02/20/2021,157,15632,55,10980,0.158,102,4652,0.067,69363,POINT (-87.662232 41.971888),60640-20210220
60640,02/21/2021,71,15703,19,10999,0.159,52,4704,0.068,69363,POINT (-87.662232 41.971888),60640-20210221
60640,02/22/2021,296,15999,98,11097,0.16,198,4902,0.071,69363,POINT (-87.662232 41.971888),60640-20210222
60640,02/23/2021,432,16431,219,11316,0.163,213,5115,0.074,69363,POINT (-87.662232 41.971888),60640-20210223
60640,02/24/2021,803,17234,307,11623,0.168,496,5611,0.081,69363,POINT (-87.662232 41.971888),60640-20210224
60640,02/25/2021,754,17988,340,11963,0.172,414,6025,0.087,69363,POINT (-87.662232 41.971888),60640-20210225
60640,02/26/2021,552,18540,293,12256,0.177,259,6284,0.091,69363,POINT (-87.662232 41.971888),60640-20210226
60640,02/27/2021,380,18920,252,12508,0.18,128,6412,0.092,69363,POINT (-87.662232 41.971888),60640-20210227
60640,02/28/2021,144,19064,60,12568,0.181,84,6496,0.094,69363,POINT (-87.662232 41.971888),60640-20210228
60640,03/01/2021,367,19431,202,12770,0.184,165,6661,0.096,69363,POINT (-87.662232 41.971888),60640-20210301
60640,03/02/2021,395,19826,233,13003,0.187,162,6823,0.098,69363,POINT (-87.662232 41.971888),60640-20210302
60640,03/03/2021,481,20307,228,13231,0.191,253,7076,0.102,69363,POINT (-87.662232 41.971888),60640-20210303
60640,03/04/2021,519,20826,267,13498,0.195,252,7328,0.106,69363,POINT (-87.662232 41.971888),60640-20210304
60640,03/05/2021,526,21352,284,13782,0.199,242,7570,0.109,69363,POINT (-87.662232 41.971888),60640-20210305
60640,03/06/2021,275,21627,166,13948,0.201,109,7679,0.111,69363,POINT (-87.662232 41.971888),60640-20210306
60641,02/21/2021,86,9822,56,7304,0.105,30,2518,0.036,69880,POINT (-87.746791 41.946682),60641-20210221
60641,02/22/2021,214,10036,95,7399,0.106,119,2637,0.038,69880,POINT (-87.746791 41.946682),60641-20210222
60641,02/23/2021,328,10364,181,7580,0.108,147,2784,0.04,69880,POINT (-87.746791 41.946682),60641-20210223
60641,02/24/2021,364,10728,181,7761,0.111,183,2967,0.042,69880,POINT (-87.746791 41.946682),60641-20210224
60641,02/25/2021,428,11156,238,7999,0.114,190,3157,0.045,69880,POINT (-87.746791 41.946682),60641-20210225
60624,02/01/2021,106,1151,96,974,0.028,10,177,0.005,34892,POINT (-87.722735 41.879417),60624-20210201
60624,02/02/2021,99,1250,75,1049,0.03,24,201,0.006,34892,POINT (-87.722735 41.879417),60624-20210202
60624,02/03/2021,115,1365,98,1147,0.033,17,218,0.006,34892,POINT (-87.722735 41.879417),60624-20210203
60624,02/04/2021,105,1470,87,1234,0.035,18,236,0.007,34892,POINT (-87.722735 41.879417),60624-20210204
60624,02/05/2021,96,1566,81,1315,0.038,15,251,0.007,34892,POINT (-87.722735 41.879417),60624-20210205
60624,02/06/2021,45,1611,36,1351,0.039,9,260,0.007,34892,POINT (-87.722735 41.879417),60624-20210206
60624,02/07/2021,19,1630,18,1369,0.039,1,261,0.007,34892,POINT (-87.722735 41.879417),60624-20210207
60624,02/08/2021,79,1709,76,1445,0.041,3,264,0.008,34892,POINT (-87.722735 41.879417),60624-20210208
60641,02/26/2021,434,11590,227,8226,0.118,207,3364,0.048,69880,POINT (-87.746791 41.946682),60641-20210226
60641,02/27/2021,397,11987,253,8479,0.121,144,3508,0.05,69880,POINT (-87.746791 41.946682),60641-20210227
60641,02/28/2021,229,12216,156,8635,0.124,73,3581,0.051,69880,POINT (-87.746791 41.946682),60641-20210228
60641,03/01/2021,316,12532,168,8803,0.126,148,3729,0.053,69880,POINT (-87.746791 41.946682),60641-20210301
60641,03/02/2021,374,12906,219,9022,0.129,155,3884,0.056,69880,POINT (-87.746791 41.946682),60641-20210302
60641,03/03/2021,462,13368,261,9283,0.133,201,4085,0.058,69880,POINT (-87.746791 41.946682),60641-20210303
60621,01/08/2021,20,254,15,241,0.009,5,13,0,28018,POINT (-87.638812 41.776931),60621-20210108
60621,01/09/2021,6,260,2,243,0.009,4,17,0.001,28018,POINT (-87.638812 41.776931),60621-20210109
60621,01/10/2021,1,261,1,244,0.009,0,17,0.001,28018,POINT (-87.638812 41.776931),60621-20210110
60621,01/11/2021,5,266,2,246,0.009,3,20,0.001,28018,POINT (-87.638812 41.776931),60621-20210111
60621,01/12/2021,20,286,15,261,0.009,5,25,0.001,28018,POINT (-87.638812 41.776931),60621-20210112
60621,01/13/2021,14,300,10,271,0.01,4,29,0.001,28018,POINT (-87.638812 41.776931),60621-20210113
60621,01/14/2021,11,311,10,281,0.01,1,30,0.001,28018,POINT (-87.638812 41.776931),60621-20210114
60621,01/15/2021,4,315,4,285,0.01,0,30,0.001,28018,POINT (-87.638812 41.776931),60621-20210115
60621,01/16/2021,8,323,6,291,0.01,2,32,0.001,28018,POINT (-87.638812 41.776931),60621-20210116
60621,01/17/2021,1,324,1,292,0.01,0,32,0.001,28018,POINT (-87.638812 41.776931),60621-20210117
60621,01/18/2021,11,335,8,300,0.011,3,35,0.001,28018,POINT (-87.638812 41.776931),60621-20210118
60621,01/19/2021,25,360,20,320,0.011,5,40,0.001,28018,POINT (-87.638812 41.776931),60621-20210119
60621,01/20/2021,23,383,15,335,0.012,8,48,0.002,28018,POINT (-87.638812 41.776931),60621-20210120
60621,01/21/2021,93,476,93,428,0.015,0,48,0.002,28018,POINT (-87.638812 41.776931),60621-20210121
60621,01/22/2021,39,515,36,464,0.017,3,51,0.002,28018,POINT (-87.638812 41.776931),60621-20210122
60621,01/23/2021,19,534,19,483,0.017,0,51,0.002,28018,POINT (-87.638812 41.776931),60621-20210123
60621,01/24/2021,3,537,3,486,0.017,0,51,0.002,28018,POINT (-87.638812 41.776931),60621-20210124
60621,01/25/2021,108,645,99,585,0.021,9,60,0.002,28018,POINT (-87.638812 41.776931),60621-20210125
60621,01/26/2021,37,682,25,610,0.022,12,72,0.003,28018,POINT (-87.638812 41.776931),60621-20210126
60621,01/27/2021,126,808,85,695,0.025,41,113,0.004,28018,POINT (-87.638812 41.776931),60621-20210127
60621,01/28/2021,50,858,43,738,0.026,7,120,0.004,28018,POINT (-87.638812 41.776931),60621-20210128
60621,01/29/2021,154,1012,100,838,0.03,54,174,0.006,28018,POINT (-87.638812 41.776931),60621-20210129
60621,01/30/2021,17,1029,15,853,0.03,2,176,0.006,28018,POINT (-87.638812 41.776931),60621-20210130
60621,01/31/2021,0,1029,0,853,0.03,0,176,0.006,28018,POINT (-87.638812 41.776931),60621-20210131
60641,03/04/2021,423,13791,212,9495,0.136,211,4296,0.061,69880,POINT (-87.746791 41.946682),60641-20210304
60641,03/05/2021,473,14264,301,9796,0.14,172,4468,0.064,69880,POINT (-87.746791 41.946682),60641-20210305
60641,03/06/2021,301,14565,146,9942,0.142,155,4623,0.066,69880,POINT (-87.746791 41.946682),60641-20210306
60642,03/06/2021,65,5799,36,3558,0.18,29,2241,0.114,19716,POINT (-87.657821 41.899935),60642-20210306
60643,03/03/2021,384,11972,150,7619,0.156,234,4353,0.089,48887,POINT (-87.662381 41.700445),60643-20210303
60643,03/04/2021,417,12389,188,7807,0.16,229,4582,0.094,48887,POINT (-87.662381 41.700445),60643-20210304
60643,03/05/2021,360,12749,198,8005,0.164,162,4744,0.097,48887,POINT (-87.662381 41.700445),60643-20210305
60643,03/06/2021,227,12976,105,8110,0.166,122,4866,0.1,48887,POINT (-87.662381 41.700445),60643-20210306
60644,03/03/2021,155,5912,62,4139,0.089,93,1773,0.038,46591,POINT (-87.756863 41.881113),60644-20210303
60644,03/04/2021,224,6136,114,4253,0.091,110,1883,0.04,46591,POINT (-87.756863 41.881113),60644-20210304
60644,03/05/2021,197,6333,115,4368,0.094,82,1965,0.042,46591,POINT (-87.756863 41.881113),60644-20210305
60644,03/06/2021,87,6420,40,4408,0.095,47,2012,0.043,46591,POINT (-87.756863 41.881113),60644-20210306
60645,02/24/2021,329,9599,129,6877,0.145,200,2722,0.058,47270,POINT (-87.695049 42.008927),60645-20210224
60645,02/25/2021,402,10001,135,7012,0.148,267,2989,0.063,47270,POINT (-87.695049 42.008927),60645-20210225
60645,02/26/2021,280,10281,156,7168,0.152,124,3113,0.066,47270,POINT (-87.695049 42.008927),60645-20210226
60645,02/27/2021,319,10600,199,7367,0.156,120,3233,0.068,47270,POINT (-87.695049 42.008927),60645-20210227
60645,02/28/2021,181,10781,89,7456,0.158,92,3325,0.07,47270,POINT (-87.695049 42.008927),60645-20210228
60645,03/01/2021,294,11075,95,7551,0.16,199,3524,0.075,47270,POINT (-87.695049 42.008927),60645-20210301
60645,03/02/2021,223,11298,122,7673,0.162,101,3625,0.077,47270,POINT (-87.695049 42.008927),60645-20210302
60645,03/03/2021,277,11575,126,7799,0.165,151,3776,0.08,47270,POINT (-87.695049 42.008927),60645-20210303
60645,03/04/2021,303,11878,128,7927,0.168,175,3951,0.084,47270,POINT (-87.695049 42.008927),60645-20210304
60645,03/05/2021,310,12188,136,8063,0.171,174,4125,0.087,47270,POINT (-87.695049 42.008927),60645-20210305
60645,03/06/2021,180,12368,104,8167,0.173,76,4201,0.089,47270,POINT (-87.695049 42.008927),60645-20210306
60646,03/03/2021,299,8928,135,5870,0.205,164,3058,0.107,28569,POINT (-87.761826 41.993931),60646-20210303
60646,03/04/2021,256,9184,122,5992,0.21,134,3192,0.112,28569,POINT (-87.761826 41.993931),60646-20210304
60646,03/05/2021,282,9466,149,6141,0.215,133,3325,0.116,28569,POINT (-87.761826 41.993931),60646-20210305
60646,03/06/2021,119,9585,41,6182,0.216,78,3403,0.119,28569,POINT (-87.761826 41.993931),60646-20210306
60647,01/27/2021,318,6134,258,4691,0.054,60,1443,0.016,87633,POINT (-87.701101 41.921058),60647-20210127
60647,01/28/2021,391,6525,324,5015,0.057,67,1510,0.017,87633,POINT (-87.701101 41.921058),60647-20210128
60647,01/29/2021,342,6867,300,5315,0.061,42,1552,0.018,87633,POINT (-87.701101 41.921058),60647-20210129
60647,01/30/2021,190,7057,145,5460,0.062,45,1597,0.018,87633,POINT (-87.701101 41.921058),60647-20210130
60647,02/02/2021,379,7730,259,5949,0.068,120,1781,0.02,87633,POINT (-87.701101 41.921058),60647-20210202
60647,02/03/2021,396,8126,325,6274,0.072,71,1852,0.021,87633,POINT (-87.701101 41.921058),60647-20210203
60647,02/04/2021,416,8542,326,6600,0.075,90,1942,0.022,87633,POINT (-87.701101 41.921058),60647-20210204
60647,02/05/2021,434,8976,331,6931,0.079,103,2045,0.023,87633,POINT (-87.701101 41.921058),60647-20210205
60647,02/06/2021,303,9279,215,7146,0.082,88,2133,0.024,87633,POINT (-87.701101 41.921058),60647-20210206
60647,02/07/2021,67,9346,51,7197,0.082,16,2149,0.025,87633,POINT (-87.701101 41.921058),60647-20210207
60647,02/08/2021,284,9630,212,7409,0.085,72,2221,0.025,87633,POINT (-87.701101 41.921058),60647-20210208
60647,02/09/2021,381,10011,265,7674,0.088,116,2337,0.027,87633,POINT (-87.701101 41.921058),60647-20210209
60647,02/10/2021,685,10696,415,8089,0.092,270,2607,0.03,87633,POINT (-87.701101 41.921058),60647-20210210
60647,02/11/2021,777,11473,334,8423,0.096,443,3050,0.035,87633,POINT (-87.701101 41.921058),60647-20210211
60647,02/12/2021,579,12052,367,8790,0.1,212,3262,0.037,87633,POINT (-87.701101 41.921058),60647-20210212
60647,02/13/2021,332,12384,236,9026,0.103,96,3358,0.038,87633,POINT (-87.701101 41.921058),60647-20210213
60647,02/14/2021,82,12466,62,9088,0.104,20,3378,0.039,87633,POINT (-87.701101 41.921058),60647-20210214
60647,02/15/2021,241,12707,161,9249,0.106,80,3458,0.039,87633,POINT (-87.701101 41.921058),60647-20210215
60647,02/16/2021,221,12928,146,9395,0.107,75,3533,0.04,87633,POINT (-87.701101 41.921058),60647-20210216
60647,02/17/2021,396,13324,208,9603,0.11,188,3721,0.042,87633,POINT (-87.701101 41.921058),60647-20210217
60647,02/18/2021,390,13714,195,9798,0.112,195,3916,0.045,87633,POINT (-87.701101 41.921058),60647-20210218
60647,02/19/2021,427,14141,213,10011,0.114,214,4130,0.047,87633,POINT (-87.701101 41.921058),60647-20210219
60647,02/20/2021,228,14369,92,10103,0.115,136,4266,0.049,87633,POINT (-87.701101 41.921058),60647-20210220
60647,02/21/2021,96,14465,35,10138,0.116,61,4327,0.049,87633,POINT (-87.701101 41.921058),60647-20210221
60647,02/22/2021,270,14735,114,10252,0.117,156,4483,0.051,87633,POINT (-87.701101 41.921058),60647-20210222
60647,02/23/2021,430,15165,212,10464,0.119,218,4701,0.054,87633,POINT (-87.701101 41.921058),60647-20210223
60647,02/24/2021,455,15620,204,10668,0.122,251,4952,0.057,87633,POINT (-87.701101 41.921058),60647-20210224
60647,02/25/2021,559,16179,260,10928,0.125,299,5251,0.06,87633,POINT (-87.701101 41.921058),60647-20210225
60647,02/26/2021,596,16775,304,11232,0.128,292,5543,0.063,87633,POINT (-87.701101 41.921058),60647-20210226
60647,02/27/2021,467,17242,292,11524,0.132,175,5718,0.065,87633,POINT (-87.701101 41.921058),60647-20210227
60647,02/28/2021,134,17376,74,11598,0.132,60,5778,0.066,87633,POINT (-87.701101 41.921058),60647-20210228
60647,03/01/2021,340,17716,166,11764,0.134,174,5952,0.068,87633,POINT (-87.701101 41.921058),60647-20210301
60647,03/02/2021,539,18255,294,12058,0.138,245,6197,0.071,87633,POINT (-87.701101 41.921058),60647-20210302
60647,03/03/2021,591,18846,351,12409,0.142,240,6437,0.073,87633,POINT (-87.701101 41.921058),60647-20210303
60647,03/04/2021,595,19441,346,12755,0.146,249,6686,0.076,87633,POINT (-87.701101 41.921058),60647-20210304
60647,03/05/2021,534,19975,315,13070,0.149,219,6905,0.079,87633,POINT (-87.701101 41.921058),60647-20210305
60647,03/06/2021,296,20271,162,13232,0.151,134,7039,0.08,87633,POINT (-87.701101 41.921058),60647-20210306
60649,03/06/2021,100,7793,48,5013,0.107,52,2780,0.06,46633,POINT (-87.571522 41.762202),60649-20210306
60651,02/02/2021,378,2452,315,2068,0.033,63,384,0.006,63492,POINT (-87.741017 41.901964),60651-20210202
60651,02/03/2021,187,2639,159,2227,0.035,28,412,0.006,63492,POINT (-87.741017 41.901964),60651-20210203
60651,02/04/2021,229,2868,208,2435,0.038,21,433,0.007,63492,POINT (-87.741017 41.901964),60651-20210204
60651,02/05/2021,200,3068,172,2607,0.041,28,461,0.007,63492,POINT (-87.741017 41.901964),60651-20210205
60651,02/06/2021,131,3199,108,2715,0.043,23,484,0.008,63492,POINT (-87.741017 41.901964),60651-20210206
60651,02/07/2021,22,3221,17,2732,0.043,5,489,0.008,63492,POINT (-87.741017 41.901964),60651-20210207
60651,02/21/2021,22,5422,17,4241,0.067,5,1181,0.019,63492,POINT (-87.741017 41.901964),60651-20210221
60651,02/22/2021,156,5578,92,4333,0.068,64,1245,0.02,63492,POINT (-87.741017 41.901964),60651-20210222
60651,02/23/2021,212,5790,109,4442,0.07,103,1348,0.021,63492,POINT (-87.741017 41.901964),60651-20210223
60651,02/24/2021,218,6008,116,4558,0.072,102,1450,0.023,63492,POINT (-87.741017 41.901964),60651-20210224
60651,02/25/2021,275,6283,136,4694,0.074,139,1589,0.025,63492,POINT (-87.741017 41.901964),60651-20210225
60651,02/26/2021,305,6588,160,4854,0.076,145,1734,0.027,63492,POINT (-87.741017 41.901964),60651-20210226
60651,02/27/2021,227,6815,168,5022,0.079,59,1793,0.028,63492,POINT (-87.741017 41.901964),60651-20210227
60651,02/28/2021,52,6867,28,5050,0.08,24,1817,0.029,63492,POINT (-87.741017 41.901964),60651-20210228
60651,03/01/2021,153,7020,69,5119,0.081,84,1901,0.03,63492,POINT (-87.741017 41.901964),60651-20210301
60651,03/02/2021,370,7390,115,5234,0.082,255,2156,0.034,63492,POINT (-87.741017 41.901964),60651-20210302
60651,03/03/2021,264,7654,143,5377,0.085,121,2277,0.036,63492,POINT (-87.741017 41.901964),60651-20210303
60651,03/04/2021,312,7966,177,5554,0.087,135,2412,0.038,63492,POINT (-87.741017 41.901964),60651-20210304
60628,01/31/2021,15,2260,12,1982,0.031,3,278,0.004,64254,POINT (-87.621537 41.694192),60628-20210131
60628,02/01/2021,227,2487,106,2088,0.032,121,399,0.006,64254,POINT (-87.621537 41.694192),60628-20210201
60628,02/02/2021,171,2658,144,2232,0.035,27,426,0.007,64254,POINT (-87.621537 41.694192),60628-20210202
60628,02/03/2021,162,2820,130,2362,0.037,32,458,0.007,64254,POINT (-87.621537 41.694192),60628-20210203
60628,02/04/2021,227,3047,194,2556,0.04,33,491,0.008,64254,POINT (-87.621537 41.694192),60628-20210204
60628,02/05/2021,212,3259,183,2739,0.043,29,520,0.008,64254,POINT (-87.621537 41.694192),60628-20210205
60628,02/06/2021,141,3400,121,2860,0.045,20,540,0.008,64254,POINT (-87.621537 41.694192),60628-20210206
60628,02/07/2021,48,3448,47,2907,0.045,1,541,0.008,64254,POINT (-87.621537 41.694192),60628-20210207
60628,02/08/2021,173,3621,140,3047,0.047,33,574,0.009,64254,POINT (-87.621537 41.694192),60628-20210208
60628,02/09/2021,222,3843,166,3213,0.05,56,630,0.01,64254,POINT (-87.621537 41.694192),60628-20210209
60628,02/10/2021,275,4118,189,3402,0.053,86,716,0.011,64254,POINT (-87.621537 41.694192),60628-20210210
60628,02/11/2021,314,4432,225,3627,0.056,89,805,0.013,64254,POINT (-87.621537 41.694192),60628-20210211
60651,03/05/2021,307,8273,181,5735,0.09,126,2538,0.04,63492,POINT (-87.741017 41.901964),60651-20210305
60651,03/06/2021,208,8481,113,5848,0.092,95,2633,0.041,63492,POINT (-87.741017 41.901964),60651-20210306
60652,02/27/2021,234,6513,146,4706,0.108,88,1807,0.042,43447,POINT (-87.714238 41.745398),60652-20210227
60652,02/28/2021,74,6587,46,4752,0.109,28,1835,0.042,43447,POINT (-87.714238 41.745398),60652-20210228
60652,03/01/2021,217,6804,120,4872,0.112,97,1932,0.044,43447,POINT (-87.714238 41.745398),60652-20210301
60652,03/02/2021,216,7020,110,4982,0.115,106,2038,0.047,43447,POINT (-87.714238 41.745398),60652-20210302
60652,03/03/2021,241,7261,109,5091,0.117,132,2170,0.05,43447,POINT (-87.714238 41.745398),60652-20210303
60652,03/05/2021,301,7800,170,5418,0.125,131,2382,0.055,43447,POINT (-87.714238 41.745398),60652-20210305
60653,03/02/2021,147,5975,58,4032,0.122,89,1943,0.059,33154,POINT (-87.611244 41.819261),60653-20210302
60653,03/03/2021,185,6160,83,4115,0.124,102,2045,0.062,33154,POINT (-87.611244 41.819261),60653-20210303
60653,03/04/2021,184,6344,101,4216,0.127,83,2128,0.064,33154,POINT (-87.611244 41.819261),60653-20210304
60653,03/05/2021,177,6521,101,4317,0.13,76,2204,0.066,33154,POINT (-87.611244 41.819261),60653-20210305
60653,03/06/2021,124,6645,53,4370,0.132,71,2275,0.069,33154,POINT (-87.611244 41.819261),60653-20210306
60654,03/04/2021,141,5607,95,3520,0.176,46,2087,0.104,20022,POINT (-87.636354 41.892485),60654-20210304
60654,03/05/2021,142,5749,91,3611,0.18,51,2138,0.107,20022,POINT (-87.636354 41.892485),60654-20210305
60654,03/06/2021,51,5800,30,3641,0.182,21,2159,0.108,20022,POINT (-87.636354 41.892485),60654-20210306
60655,02/27/2021,190,8505,76,5326,0.186,114,3179,0.111,28569,POINT (-87.701434 41.696456),60655-20210227
60655,02/28/2021,43,8548,21,5347,0.187,22,3201,0.112,28569,POINT (-87.701434 41.696456),60655-20210228
60655,03/01/2021,169,8717,72,5419,0.19,97,3298,0.115,28569,POINT (-87.701434 41.696456),60655-20210301
60655,03/02/2021,217,8934,83,5502,0.193,134,3432,0.12,28569,POINT (-87.701434 41.696456),60655-20210302
60655,03/03/2021,238,9172,85,5587,0.196,153,3585,0.125,28569,POINT (-87.701434 41.696456),60655-20210303
60655,03/04/2021,258,9430,106,5693,0.199,152,3737,0.131,28569,POINT (-87.701434 41.696456),60655-20210304
60655,03/05/2021,215,9645,91,5784,0.202,124,3861,0.135,28569,POINT (-87.701434 41.696456),60655-20210305
60655,03/06/2021,104,9749,37,5821,0.204,67,3928,0.137,28569,POINT (-87.701434 41.696456),60655-20210306
60656,02/20/2021,95,4027,39,3046,0.108,56,981,0.035,28218,POINT (-87.817934 41.974566),60656-20210220
60656,02/21/2021,26,4053,12,3058,0.108,14,995,0.035,28218,POINT (-87.817934 41.974566),60656-20210221
60656,02/22/2021,136,4189,63,3121,0.111,73,1068,0.038,28218,POINT (-87.817934 41.974566),60656-20210222
60656,02/23/2021,116,4305,62,3183,0.113,54,1122,0.04,28218,POINT (-87.817934 41.974566),60656-20210223
60656,02/24/2021,162,4467,78,3261,0.116,84,1206,0.043,28218,POINT (-87.817934 41.974566),60656-20210224
60656,02/25/2021,181,4648,86,3347,0.119,95,1301,0.046,28218,POINT (-87.817934 41.974566),60656-20210225
60626,01/14/2021,273,2101,262,1797,0.036,11,304,0.006,50544,POINT (-87.669834 42.009469),60626-20210114
60626,01/15/2021,268,2369,257,2054,0.041,11,315,0.006,50544,POINT (-87.669834 42.009469),60626-20210115
60626,01/16/2021,53,2422,49,2103,0.042,4,319,0.006,50544,POINT (-87.669834 42.009469),60626-20210116
60626,01/17/2021,21,2443,14,2117,0.042,7,326,0.006,50544,POINT (-87.669834 42.009469),60626-20210117
60626,01/18/2021,236,2679,219,2336,0.046,17,343,0.007,50544,POINT (-87.669834 42.009469),60626-20210118
60626,01/19/2021,100,2779,63,2399,0.047,37,380,0.008,50544,POINT (-87.669834 42.009469),60626-20210119
60626,01/20/2021,144,2923,112,2511,0.05,32,412,0.008,50544,POINT (-87.669834 42.009469),60626-20210120
60626,01/21/2021,187,3110,154,2665,0.053,33,445,0.009,50544,POINT (-87.669834 42.009469),60626-20210121
60626,01/22/2021,154,3264,146,2811,0.056,8,453,0.009,50544,POINT (-87.669834 42.009469),60626-20210122
60656,02/26/2021,209,4857,110,3457,0.123,99,1400,0.05,28218,POINT (-87.817934 41.974566),60656-20210226
60656,02/27/2021,133,4990,67,3524,0.125,66,1466,0.052,28218,POINT (-87.817934 41.974566),60656-20210227
60656,02/28/2021,43,5033,19,3543,0.126,24,1490,0.053,28218,POINT (-87.817934 41.974566),60656-20210228
60656,03/01/2021,122,5155,77,3620,0.128,45,1535,0.054,28218,POINT (-87.817934 41.974566),60656-20210301
60656,03/02/2021,152,5307,72,3692,0.131,80,1615,0.057,28218,POINT (-87.817934 41.974566),60656-20210302
60656,03/03/2021,213,5520,113,3805,0.135,100,1715,0.061,28218,POINT (-87.817934 41.974566),60656-20210303
60656,03/05/2021,177,5889,84,3969,0.141,93,1920,0.068,28218,POINT (-87.817934 41.974566),60656-20210305
60656,03/06/2021,96,5985,45,4014,0.142,51,1971,0.07,28218,POINT (-87.817934 41.974566),60656-20210306
60657,02/06/2021,277,11583,185,8383,0.118,92,3200,0.045,70958,POINT (-87.658216 41.939715),60657-20210206
60657,02/07/2021,355,11938,247,8630,0.122,108,3308,0.047,70958,POINT (-87.658216 41.939715),60657-20210207
60657,02/09/2021,365,12578,217,9048,0.128,148,3530,0.05,70958,POINT (-87.658216 41.939715),60657-20210209
60657,02/10/2021,475,13053,335,9383,0.132,140,3670,0.052,70958,POINT (-87.658216 41.939715),60657-20210210
60657,02/11/2021,523,13576,275,9658,0.136,248,3918,0.055,70958,POINT (-87.658216 41.939715),60657-20210211
60657,02/12/2021,560,14136,307,9965,0.14,253,4171,0.059,70958,POINT (-87.658216 41.939715),60657-20210212
60657,02/13/2021,375,14511,219,10184,0.144,156,4327,0.061,70958,POINT (-87.658216 41.939715),60657-20210213
60657,02/14/2021,324,14835,87,10271,0.145,237,4564,0.064,70958,POINT (-87.658216 41.939715),60657-20210214
60657,02/15/2021,257,15092,107,10378,0.146,150,4714,0.066,70958,POINT (-87.658216 41.939715),60657-20210215
60657,02/16/2021,271,15363,189,10567,0.149,82,4796,0.068,70958,POINT (-87.658216 41.939715),60657-20210216
60657,02/17/2021,325,15688,154,10721,0.151,171,4967,0.07,70958,POINT (-87.658216 41.939715),60657-20210217
60657,02/18/2021,445,16133,195,10916,0.154,250,5217,0.074,70958,POINT (-87.658216 41.939715),60657-20210218
60657,02/19/2021,401,16534,125,11041,0.156,276,5493,0.077,70958,POINT (-87.658216 41.939715),60657-20210219
60657,02/20/2021,192,16726,64,11105,0.157,128,5621,0.079,70958,POINT (-87.658216 41.939715),60657-20210220
60657,02/21/2021,114,16840,50,11155,0.157,64,5685,0.08,70958,POINT (-87.658216 41.939715),60657-20210221
60602,03/01/2021,10,665,4,408,0.356,6,257,0.224,1145,POINT (-87.628309 41.883136),60602-20210301
60602,03/02/2021,9,674,4,412,0.36,5,262,0.229,1145,POINT (-87.628309 41.883136),60602-20210302
60602,03/03/2021,20,694,4,416,0.363,16,278,0.243,1145,POINT (-87.628309 41.883136),60602-20210303
60602,03/04/2021,15,709,12,428,0.374,3,281,0.245,1145,POINT (-87.628309 41.883136),60602-20210304
60602,03/05/2021,11,720,10,438,0.383,1,282,0.246,1145,POINT (-87.628309 41.883136),60602-20210305
60603,02/16/2021,18,533,12,406,0.386,6,127,0.121,1052,POINT (-87.625473 41.880112),60603-20210216
60603,02/17/2021,12,545,4,410,0.39,8,135,0.128,1052,POINT (-87.625473 41.880112),60603-20210217
60603,02/18/2021,10,555,6,416,0.395,4,139,0.132,1052,POINT (-87.625473 41.880112),60603-20210218
60603,02/20/2021,15,582,1,419,0.398,14,163,0.155,1052,POINT (-87.625473 41.880112),60603-20210220
60603,02/21/2021,1,583,1,420,0.399,0,163,0.155,1052,POINT (-87.625473 41.880112),60603-20210221
60603,02/22/2021,6,589,2,422,0.401,4,167,0.159,1052,POINT (-87.625473 41.880112),60603-20210222
60603,02/23/2021,30,619,12,434,0.413,18,185,0.176,1052,POINT (-87.625473 41.880112),60603-20210223
60603,02/24/2021,75,694,16,450,0.428,59,244,0.232,1052,POINT (-87.625473 41.880112),60603-20210224
60603,02/25/2021,12,706,4,454,0.432,8,252,0.24,1052,POINT (-87.625473 41.880112),60603-20210225
60626,01/23/2021,69,3333,67,2878,0.057,2,455,0.009,50544,POINT (-87.669834 42.009469),60626-20210123
60626,01/24/2021,30,3363,28,2906,0.057,2,457,0.009,50544,POINT (-87.669834 42.009469),60626-20210124
60626,01/25/2021,114,3477,79,2985,0.059,35,492,0.01,50544,POINT (-87.669834 42.009469),60626-20210125
60657,02/22/2021,307,17147,93,11248,0.159,214,5899,0.083,70958,POINT (-87.658216 41.939715),60657-20210222
60657,02/23/2021,424,17571,218,11466,0.162,206,6105,0.086,70958,POINT (-87.658216 41.939715),60657-20210223
60630,02/01/2021,163,4004,113,3148,0.056,50,856,0.015,56433,POINT (-87.759611 41.971261),60630-20210201
60630,02/02/2021,348,4352,219,3367,0.06,129,985,0.017,56433,POINT (-87.759611 41.971261),60630-20210202
60630,02/03/2021,266,4618,201,3568,0.063,65,1050,0.019,56433,POINT (-87.759611 41.971261),60630-20210203
60630,02/04/2021,323,4941,261,3829,0.068,62,1112,0.02,56433,POINT (-87.759611 41.971261),60630-20210204
60630,02/05/2021,342,5283,267,4096,0.073,75,1187,0.021,56433,POINT (-87.759611 41.971261),60630-20210205
60630,02/06/2021,241,5524,190,4286,0.076,51,1238,0.022,56433,POINT (-87.759611 41.971261),60630-20210206
60630,02/07/2021,59,5583,52,4338,0.077,7,1245,0.022,56433,POINT (-87.759611 41.971261),60630-20210207
60630,02/08/2021,211,5794,172,4510,0.08,39,1284,0.023,56433,POINT (-87.759611 41.971261),60630-20210208
60657,02/24/2021,418,17989,174,11640,0.164,244,6349,0.089,70958,POINT (-87.658216 41.939715),60657-20210224
60657,02/25/2021,489,18478,169,11809,0.166,320,6669,0.094,70958,POINT (-87.658216 41.939715),60657-20210225
60657,02/26/2021,579,19057,187,11996,0.169,392,7061,0.1,70958,POINT (-87.658216 41.939715),60657-20210226
60657,02/27/2021,353,19410,197,12193,0.172,156,7217,0.102,70958,POINT (-87.658216 41.939715),60657-20210227
60657,02/28/2021,152,19562,72,12265,0.173,80,7297,0.103,70958,POINT (-87.658216 41.939715),60657-20210228
60657,03/01/2021,343,19905,178,12443,0.175,165,7462,0.105,70958,POINT (-87.658216 41.939715),60657-20210301
60657,03/02/2021,397,20302,213,12656,0.178,184,7646,0.108,70958,POINT (-87.658216 41.939715),60657-20210302
60657,03/03/2021,526,20828,238,12894,0.182,288,7934,0.112,70958,POINT (-87.658216 41.939715),60657-20210303
60657,03/04/2021,476,21304,282,13176,0.186,194,8128,0.115,70958,POINT (-87.658216 41.939715),60657-20210304
60657,03/05/2021,470,21774,256,13432,0.189,214,8342,0.118,70958,POINT (-87.658216 41.939715),60657-20210305
60657,03/06/2021,230,22004,125,13557,0.191,105,8447,0.119,70958,POINT (-87.658216 41.939715),60657-20210306
60659,02/22/2021,119,6267,51,4518,0.106,68,1749,0.041,42735,POINT (-87.703266 41.990803),60659-20210222
60659,02/24/2021,193,6661,88,4733,0.111,105,1928,0.045,42735,POINT (-87.703266 41.990803),60659-20210224
60659,02/25/2021,283,6944,101,4834,0.113,182,2110,0.049,42735,POINT (-87.703266 41.990803),60659-20210225
60659,02/26/2021,229,7173,128,4962,0.116,101,2211,0.052,42735,POINT (-87.703266 41.990803),60659-20210226
60659,02/27/2021,216,7389,123,5085,0.119,93,2304,0.054,42735,POINT (-87.703266 41.990803),60659-20210227
60659,02/28/2021,89,7478,39,5124,0.12,50,2354,0.055,42735,POINT (-87.703266 41.990803),60659-20210228
60659,03/01/2021,188,7666,87,5211,0.122,101,2455,0.057,42735,POINT (-87.703266 41.990803),60659-20210301
60659,03/02/2021,189,7855,104,5315,0.124,85,2540,0.059,42735,POINT (-87.703266 41.990803),60659-20210302
60659,03/03/2021,241,8096,97,5412,0.127,144,2684,0.063,42735,POINT (-87.703266 41.990803),60659-20210303
60659,03/04/2021,240,8336,99,5511,0.129,141,2825,0.066,42735,POINT (-87.703266 41.990803),60659-20210304
60659,03/05/2021,244,8580,134,5645,0.132,110,2935,0.069,42735,POINT (-87.703266 41.990803),60659-20210305
60659,03/06/2021,108,8688,54,5699,0.133,54,2989,0.07,42735,POINT (-87.703266 41.990803),60659-20210306
60660,02/19/2021,267,8773,113,6199,0.139,154,2574,0.058,44498,POINT (-87.666362 41.991062),60660-20210219
60631,02/02/2021,180,3542,134,2787,0.094,46,755,0.026,29529,POINT (-87.813371 41.995019),60631-20210202
60631,02/03/2021,207,3749,168,2955,0.1,39,794,0.027,29529,POINT (-87.813371 41.995019),60631-20210203
60631,02/04/2021,210,3959,174,3129,0.106,36,830,0.028,29529,POINT (-87.813371 41.995019),60631-20210204
60631,02/05/2021,349,4308,234,3363,0.114,115,945,0.032,29529,POINT (-87.813371 41.995019),60631-20210205
60631,02/06/2021,434,4742,417,3780,0.128,17,962,0.033,29529,POINT (-87.813371 41.995019),60631-20210206
60631,02/07/2021,45,4787,38,3818,0.129,7,969,0.033,29529,POINT (-87.813371 41.995019),60631-20210207
60631,02/08/2021,187,4974,144,3962,0.134,43,1012,0.034,29529,POINT (-87.813371 41.995019),60631-20210208
60660,02/20/2021,94,8867,33,6232,0.14,61,2635,0.059,44498,POINT (-87.666362 41.991062),60660-20210220
60660,02/21/2021,55,8922,26,6258,0.141,29,2664,0.06,44498,POINT (-87.666362 41.991062),60660-20210221
60660,02/22/2021,188,9110,64,6322,0.142,124,2788,0.063,44498,POINT (-87.666362 41.991062),60660-20210222
60660,02/23/2021,240,9350,137,6459,0.145,103,2891,0.065,44498,POINT (-87.666362 41.991062),60660-20210223
60660,02/24/2021,272,9622,146,6605,0.148,126,3017,0.068,44498,POINT (-87.666362 41.991062),60660-20210224
60660,02/25/2021,297,9919,120,6725,0.151,177,3194,0.072,44498,POINT (-87.666362 41.991062),60660-20210225
60660,02/26/2021,323,10242,139,6864,0.154,184,3378,0.076,44498,POINT (-87.666362 41.991062),60660-20210226
60660,02/27/2021,227,10469,135,6999,0.157,92,3470,0.078,44498,POINT (-87.666362 41.991062),60660-20210227
60660,02/28/2021,80,10549,34,7033,0.158,46,3516,0.079,44498,POINT (-87.666362 41.991062),60660-20210228
60660,03/01/2021,199,10748,106,7139,0.16,93,3609,0.081,44498,POINT (-87.666362 41.991062),60660-20210301
60660,03/02/2021,248,10996,145,7284,0.164,103,3712,0.083,44498,POINT (-87.666362 41.991062),60660-20210302
60660,03/03/2021,374,11370,156,7440,0.167,218,3930,0.088,44498,POINT (-87.666362 41.991062),60660-20210303
60660,03/04/2021,388,11758,212,7652,0.172,176,4106,0.092,44498,POINT (-87.666362 41.991062),60660-20210304
60660,03/05/2021,305,12063,202,7854,0.177,103,4209,0.095,44498,POINT (-87.666362 41.991062),60660-20210305
60660,03/06/2021,139,12202,68,7922,0.178,71,4280,0.096,44498,POINT (-87.666362 41.991062),60660-20210306
60661,02/28/2021,15,2724,7,1673,0.162,8,1051,0.102,10354,POINT (-87.644283 41.882786),60661-20210228
60661,03/01/2021,47,2771,29,1702,0.164,18,1069,0.103,10354,POINT (-87.644283 41.882786),60661-20210301
60661,03/02/2021,45,2816,25,1727,0.167,20,1089,0.105,10354,POINT (-87.644283 41.882786),60661-20210302
60661,03/03/2021,75,2891,28,1755,0.169,47,1136,0.11,10354,POINT (-87.644283 41.882786),60661-20210303
60661,03/04/2021,51,2942,29,1784,0.172,22,1158,0.112,10354,POINT (-87.644283 41.882786),60661-20210304
60661,03/05/2021,56,2998,28,1812,0.175,28,1186,0.115,10354,POINT (-87.644283 41.882786),60661-20210305
60661,03/06/2021,23,3021,6,1818,0.176,17,1203,0.116,10354,POINT (-87.644283 41.882786),60661-20210306
60707,03/06/2021,66,3164,32,2185,0.051,34,979,0.023,43093,POINT (-87.808283 41.921777),60707-20210306
Unknown,03/06/2021,36,2353,20,1459,0,16,894,0,0,,Unknown-20210306
60601,03/07/2021,5,4370,4,2671,0.177,1,1699,0.113,15083,POINT (-87.622844 41.886262),60601-20210307
60606,03/07/2021,1,1145,1,702,0.214,0,443,0.135,3287,POINT (-87.63676 41.882634),60606-20210307
60611,03/07/2021,10,16952,7,9755,0.294,3,7197,0.217,33224,POINT (-87.620291 41.894734),60611-20210307
60666,03/07/2021,0,37,0,24,0,0,13,0,0,POINT (-87.896371 41.979511),60666-20210307
60645,03/07/2021,157,12525,99,8266,0.175,58,4259,0.09,47270,POINT (-87.695049 42.008927),60645-20210307
60625,03/07/2021,61,18527,49,12176,0.153,12,6351,0.08,79444,POINT (-87.701816 41.971155),60625-20210307
60640,03/07/2021,39,21666,32,13980,0.202,7,7686,0.111,69363,POINT (-87.662232 41.971888),60640-20210307
60626,03/07/2021,31,12208,26,7886,0.156,5,4322,0.086,50544,POINT (-87.669834 42.009469),60626-20210307
60657,03/07/2021,72,22076,53,13610,0.192,19,8466,0.119,70958,POINT (-87.658216 41.939715),60657-20210307
60615,03/07/2021,9,12362,4,7308,0.18,5,5054,0.125,40590,POINT (-87.602725 41.801993),60615-20210307
60621,03/07/2021,8,3341,5,2408,0.086,3,933,0.033,28018,POINT (-87.638812 41.776931),60621-20210307
60651,03/07/2021,22,8503,15,5863,0.092,7,2640,0.042,63492,POINT (-87.741017 41.901964),60651-20210307
60707,03/07/2021,6,3170,6,2191,0.051,0,979,0.023,43093,POINT (-87.808283 41.921777),60707-20210307
60631,03/07/2021,17,10414,9,6774,0.229,8,3640,0.123,29529,POINT (-87.813371 41.995019),60631-20210307
60602,03/07/2021,0,726,0,440,0.384,0,286,0.25,1145,POINT (-87.628309 41.883136),60602-20210307
60607,03/07/2021,11,10415,8,6159,0.21,3,4256,0.145,29293,POINT (-87.652727 41.876104),60607-20210307
60630,03/07/2021,37,13266,26,8783,0.156,11,4483,0.079,56433,POINT (-87.759611 41.971261),60630-20210307
60641,03/07/2021,37,14602,29,9971,0.143,8,4631,0.066,69880,POINT (-87.746791 41.946682),60641-20210307
60622,03/07/2021,26,15813,21,9961,0.187,5,5852,0.11,53294,POINT (-87.681818 41.902762),60622-20210307
60636,03/07/2021,8,3727,4,2673,0.089,4,1054,0.035,30024,POINT (-87.668597 41.77599),60636-20210307
60610,03/07/2021,22,12685,14,7825,0.193,8,4860,0.12,40548,POINT (-87.63581 41.90455),60610-20210307
60659,03/07/2021,45,8733,26,5725,0.134,19,3008,0.07,42735,POINT (-87.703266 41.990803),60659-20210307
60614,03/07/2021,50,21213,34,13019,0.181,16,8194,0.114,71954,POINT (-87.652064 41.922605),60614-20210307
60644,03/07/2021,8,6428,7,4415,0.095,1,2013,0.043,46591,POINT (-87.756863 41.881113),60644-20210307
60603,03/07/2021,0,771,0,486,0.462,0,285,0.271,1052,POINT (-87.625473 41.880112),60603-20210307
60634,03/07/2021,45,17069,36,11472,0.153,9,5597,0.075,75082,POINT (-87.797373 41.944967),60634-20210307
60637,03/07/2021,9,8819,1,5343,0.113,8,3476,0.073,47300,POINT (-87.604053 41.780991),60637-20210307
60649,03/07/2021,10,7803,4,5017,0.108,6,2786,0.06,46633,POINT (-87.571522 41.762202),60649-20210307
60618,03/07/2021,51,22089,38,14428,0.152,13,7661,0.081,94907,POINT (-87.703343 41.946699),60618-20210307
60623,03/07/2021,6,16539,5,12698,0.156,1,3841,0.047,81283,POINT (-87.717446 41.850321),60623-20210307
60647,03/07/2021,53,20324,43,13275,0.151,10,7049,0.08,87633,POINT (-87.701101 41.921058),60647-20210307
Unknown,03/07/2021,2,2355,2,1461,0,0,894,0,0,,Unknown-20210307
60629,03/07/2021,9,20057,6,15203,0.138,3,4854,0.044,110029,POINT (-87.711565 41.777061),60629-20210307
60613,03/07/2021,38,15184,31,9562,0.188,7,5622,0.111,50761,POINT (-87.661343 41.953742),60613-20210307
60660,03/07/2021,25,12227,16,7938,0.178,9,4289,0.096,44498,POINT (-87.666362 41.991062),60660-20210307
60654,03/07/2021,17,5817,13,3654,0.182,4,2163,0.108,20022,POINT (-87.636354 41.892485),60654-20210307
60608,03/07/2021,20,17963,15,11888,0.148,5,6075,0.076,80059,POINT (-87.670366 41.849879),60608-20210307
60642,03/07/2021,12,5811,8,3566,0.181,4,2245,0.114,19716,POINT (-87.657821 41.899935),60642-20210307
60604,03/07/2021,0,508,0,308,0.374,0,200,0.243,823,POINT (-87.629029 41.878153),60604-20210307
60638,03/07/2021,8,12745,6,8500,0.145,2,4245,0.072,58669,POINT (-87.771902 41.787032),60638-20210307
60653,03/07/2021,6,6651,3,4373,0.132,3,2278,0.069,33154,POINT (-87.611244 41.819261),60653-20210307
60619,03/07/2021,23,10945,7,7192,0.118,16,3753,0.061,61207,POINT (-87.60569 41.744737),60619-20210307
60655,03/07/2021,19,9768,11,5832,0.204,8,3936,0.138,28569,POINT (-87.701434 41.696456),60655-20210307
60617,03/07/2021,26,13933,5,9243,0.111,21,4690,0.056,83553,POINT (-87.556897 41.721257),60617-20210307
60633,03/07/2021,2,1668,0,1107,0.087,2,561,0.044,12689,POINT (-87.556037 41.653147),60633-20210307
60612,03/07/2021,5,8380,3,5210,0.154,2,3170,0.094,33735,POINT (-87.687011 41.88004),60612-20210307
60646,03/07/2021,21,9606,13,6195,0.217,8,3411,0.119,28569,POINT (-87.761826 41.993931),60646-20210307
60643,03/07/2021,49,13025,20,8130,0.166,29,4895,0.1,48887,POINT (-87.662381 41.700445),60643-20210307
60628,03/07/2021,29,9549,12,6358,0.099,17,3191,0.05,64254,POINT (-87.621537 41.694192),60628-20210307
60661,03/07/2021,5,3026,4,1822,0.176,1,1204,0.116,10354,POINT (-87.644283 41.882786),60661-20210307
60624,03/07/2021,5,4447,3,3146,0.09,2,1301,0.037,34892,POINT (-87.722735 41.879417),60624-20210307
60609,03/07/2021,13,9846,6,6746,0.111,7,3100,0.051,60939,POINT (-87.653382 41.812017),60609-20210307
60636,02/03/2021,68,999,53,865,0.029,15,134,0.004,30024,POINT (-87.668597 41.77599),60636-20210203
60636,02/04/2021,84,1083,72,937,0.031,12,146,0.005,30024,POINT (-87.668597 41.77599),60636-20210204
60636,02/05/2021,75,1158,64,1001,0.033,11,157,0.005,30024,POINT (-87.668597 41.77599),60636-20210205
60827,03/07/2021,1,285,0,194,0.007,1,91,0.003,28483,POINT (-87.633087 41.650765),60827-20210307
60639,03/07/2021,45,16688,33,12790,0.145,12,3898,0.044,88204,POINT (-87.75531 41.920609),60639-20210307
60632,03/07/2021,15,17434,12,13103,0.146,3,4331,0.048,89857,POINT (-87.711251 41.810038),60632-20210307
60656,03/07/2021,20,6005,9,4023,0.143,11,1982,0.07,28218,POINT (-87.817934 41.974566),60656-20210307
60620,03/07/2021,35,9825,8,6721,0.099,27,3104,0.046,67711,POINT (-87.651656 41.740873),60620-20210307
60605,03/07/2021,20,10721,10,6398,0.22,10,4323,0.149,29060,POINT (-87.623449 41.867824),60605-20210307
60652,03/07/2021,23,7988,16,5537,0.127,7,2451,0.056,43447,POINT (-87.714238 41.745398),60652-20210307
60616,03/07/2021,13,14203,8,9120,0.168,5,5083,0.094,54197,POINT (-87.629531 41.844869),60616-20210307
60634,12/15/2020,0,0,0,0,0,0,0,0,75082,POINT (-87.797373 41.944967),60634-20201215
60634,12/16/2020,2,2,2,2,0,0,0,0,75082,POINT (-87.797373 41.944967),60634-20201216
60634,12/17/2020,29,31,29,31,0,0,0,0,75082,POINT (-87.797373 41.944967),60634-20201217
60634,12/18/2020,105,136,105,136,0.002,0,0,0,75082,POINT (-87.797373 41.944967),60634-20201218
60634,12/19/2020,74,210,74,210,0.003,0,0,0,75082,POINT (-87.797373 41.944967),60634-20201219
60634,12/20/2020,20,230,20,230,0.003,0,0,0,75082,POINT (-87.797373 41.944967),60634-20201220
60634,12/21/2020,97,327,97,327,0.004,0,0,0,75082,POINT (-87.797373 41.944967),60634-20201221
60634,12/22/2020,71,398,71,398,0.005,0,0,0,75082,POINT (-87.797373 41.944967),60634-20201222
60634,12/23/2020,53,451,53,451,0.006,0,0,0,75082,POINT (-87.797373 41.944967),60634-20201223
60634,12/24/2020,7,458,7,458,0.006,0,0,0,75082,POINT (-87.797373 41.944967),60634-20201224
60634,12/25/2020,0,458,0,458,0.006,0,0,0,75082,POINT (-87.797373 41.944967),60634-20201225
60634,12/26/2020,9,467,9,467,0.006,0,0,0,75082,POINT (-87.797373 41.944967),60634-20201226
60634,12/27/2020,0,467,0,467,0.006,0,0,0,75082,POINT (-87.797373 41.944967),60634-20201227
60634,12/28/2020,25,492,25,492,0.007,0,0,0,75082,POINT (-87.797373 41.944967),60634-20201228
60634,12/29/2020,106,598,106,598,0.008,0,0,0,75082,POINT (-87.797373 41.944967),60634-20201229
60634,12/30/2020,73,671,73,671,0.009,0,0,0,75082,POINT (-87.797373 41.944967),60634-20201230
60634,12/31/2020,57,728,57,728,0.01,0,0,0,75082,POINT (-87.797373 41.944967),60634-20201231
60634,01/01/2021,1,729,1,729,0.01,0,0,0,75082,POINT (-87.797373 41.944967),60634-20210101
60634,01/02/2021,115,844,115,844,0.011,0,0,0,75082,POINT (-87.797373 41.944967),60634-20210102
60634,01/03/2021,16,860,16,860,0.011,0,0,0,75082,POINT (-87.797373 41.944967),60634-20210103
60634,01/04/2021,100,960,99,959,0.013,1,1,0,75082,POINT (-87.797373 41.944967),60634-20210104
60634,01/05/2021,94,1054,89,1048,0.014,5,6,0,75082,POINT (-87.797373 41.944967),60634-20210105
60634,01/06/2021,71,1125,56,1104,0.015,15,21,0,75082,POINT (-87.797373 41.944967),60634-20210106
60634,01/07/2021,120,1245,57,1161,0.015,63,84,0.001,75082,POINT (-87.797373 41.944967),60634-20210107
60634,01/08/2021,320,1565,218,1379,0.018,102,186,0.002,75082,POINT (-87.797373 41.944967),60634-20210108
60636,01/25/2021,57,534,44,457,0.015,13,77,0.003,30024,POINT (-87.668597 41.77599),60636-20210125
60636,01/26/2021,47,581,41,498,0.017,6,83,0.003,30024,POINT (-87.668597 41.77599),60636-20210126
60636,01/27/2021,61,642,52,550,0.018,9,92,0.003,30024,POINT (-87.668597 41.77599),60636-20210127
60636,01/28/2021,59,701,56,606,0.02,3,95,0.003,30024,POINT (-87.668597 41.77599),60636-20210128
60636,01/29/2021,107,808,101,707,0.024,6,101,0.003,30024,POINT (-87.668597 41.77599),60636-20210129
60636,01/30/2021,26,834,24,731,0.024,2,103,0.003,30024,POINT (-87.668597 41.77599),60636-20210130
60636,01/31/2021,3,837,2,733,0.024,1,104,0.003,30024,POINT (-87.668597 41.77599),60636-20210131
60636,02/01/2021,41,878,37,770,0.026,4,108,0.004,30024,POINT (-87.668597 41.77599),60636-20210201
60636,02/02/2021,53,931,42,812,0.027,11,119,0.004,30024,POINT (-87.668597 41.77599),60636-20210202
60603,02/26/2021,13,719,3,457,0.434,10,262,0.249,1052,POINT (-87.625473 41.880112),60603-20210226
60603,02/27/2021,4,723,2,459,0.436,2,264,0.251,1052,POINT (-87.625473 41.880112),60603-20210227
60603,02/28/2021,3,726,1,460,0.437,2,266,0.253,1052,POINT (-87.625473 41.880112),60603-20210228
60603,03/02/2021,7,740,2,466,0.443,5,274,0.26,1052,POINT (-87.625473 41.880112),60603-20210302
60603,03/03/2021,6,746,2,468,0.445,4,278,0.264,1052,POINT (-87.625473 41.880112),60603-20210303
60605,02/06/2021,114,6383,74,4297,0.148,40,2086,0.072,29060,POINT (-87.623449 41.867824),60605-20210206
60605,02/07/2021,30,6413,26,4323,0.149,4,2090,0.072,29060,POINT (-87.623449 41.867824),60605-20210207
60605,02/08/2021,122,6535,79,4402,0.151,43,2133,0.073,29060,POINT (-87.623449 41.867824),60605-20210208
60605,02/09/2021,121,6656,76,4478,0.154,45,2178,0.075,29060,POINT (-87.623449 41.867824),60605-20210209
60605,02/10/2021,218,6874,161,4639,0.16,57,2235,0.077,29060,POINT (-87.623449 41.867824),60605-20210210
60605,02/11/2021,205,7079,84,4723,0.163,121,2356,0.081,29060,POINT (-87.623449 41.867824),60605-20210211
60605,02/12/2021,270,7349,110,4833,0.166,160,2516,0.087,29060,POINT (-87.623449 41.867824),60605-20210212
60605,02/13/2021,130,7479,67,4900,0.169,63,2579,0.089,29060,POINT (-87.623449 41.867824),60605-20210213
60639,01/13/2021,85,1163,58,975,0.011,27,188,0.002,88204,POINT (-87.75531 41.920609),60639-20210113
60639,01/14/2021,82,1245,69,1044,0.012,13,201,0.002,88204,POINT (-87.75531 41.920609),60639-20210114
60639,01/15/2021,68,1313,67,1111,0.013,1,202,0.002,88204,POINT (-87.75531 41.920609),60639-20210115
60639,01/16/2021,53,1366,50,1161,0.013,3,205,0.002,88204,POINT (-87.75531 41.920609),60639-20210116
60639,01/17/2021,8,1374,6,1167,0.013,2,207,0.002,88204,POINT (-87.75531 41.920609),60639-20210117
60639,01/18/2021,63,1437,49,1216,0.014,14,221,0.003,88204,POINT (-87.75531 41.920609),60639-20210118
60643,02/01/2021,113,3770,95,3179,0.065,18,591,0.012,48887,POINT (-87.662381 41.700445),60643-20210201
60643,02/02/2021,232,4002,185,3364,0.069,47,638,0.013,48887,POINT (-87.662381 41.700445),60643-20210202
60643,02/03/2021,369,4371,253,3617,0.074,116,754,0.015,48887,POINT (-87.662381 41.700445),60643-20210203
60643,02/04/2021,292,4663,265,3882,0.079,27,781,0.016,48887,POINT (-87.662381 41.700445),60643-20210204
60640,01/20/2021,321,4710,242,3767,0.054,79,943,0.014,69363,POINT (-87.662232 41.971888),60640-20210120
60640,01/21/2021,485,5195,428,4195,0.06,57,1000,0.014,69363,POINT (-87.662232 41.971888),60640-20210121
60640,01/22/2021,239,5434,211,4406,0.064,28,1028,0.015,69363,POINT (-87.662232 41.971888),60640-20210122
60640,01/23/2021,131,5565,119,4525,0.065,12,1040,0.015,69363,POINT (-87.662232 41.971888),60640-20210123
60640,01/24/2021,72,5637,69,4594,0.066,3,1043,0.015,69363,POINT (-87.662232 41.971888),60640-20210124
60640,01/25/2021,208,5845,152,4746,0.068,56,1099,0.016,69363,POINT (-87.662232 41.971888),60640-20210125
60644,02/02/2021,415,2412,228,1902,0.041,187,510,0.011,46591,POINT (-87.756863 41.881113),60644-20210202
60644,02/03/2021,145,2557,127,2029,0.044,18,528,0.011,46591,POINT (-87.756863 41.881113),60644-20210203
60644,02/04/2021,178,2735,168,2197,0.047,10,538,0.012,46591,POINT (-87.756863 41.881113),60644-20210204
60644,02/05/2021,157,2892,148,2345,0.05,9,547,0.012,46591,POINT (-87.756863 41.881113),60644-20210205
60644,02/06/2021,68,2960,57,2402,0.052,11,558,0.012,46591,POINT (-87.756863 41.881113),60644-20210206
60644,02/07/2021,6,2966,5,2407,0.052,1,559,0.012,46591,POINT (-87.756863 41.881113),60644-20210207
60644,02/08/2021,82,3048,75,2482,0.053,7,566,0.012,46591,POINT (-87.756863 41.881113),60644-20210208
60644,02/09/2021,129,3177,106,2588,0.056,23,589,0.013,46591,POINT (-87.756863 41.881113),60644-20210209
60644,02/10/2021,277,3454,162,2750,0.059,115,704,0.015,46591,POINT (-87.756863 41.881113),60644-20210210
60644,02/11/2021,180,3634,119,2869,0.062,61,765,0.016,46591,POINT (-87.756863 41.881113),60644-20210211
60644,02/12/2021,169,3803,109,2978,0.064,60,825,0.018,46591,POINT (-87.756863 41.881113),60644-20210212
60644,02/13/2021,101,3904,70,3048,0.065,31,856,0.018,46591,POINT (-87.756863 41.881113),60644-20210213
60644,02/14/2021,14,3918,13,3061,0.066,1,857,0.018,46591,POINT (-87.756863 41.881113),60644-20210214
60644,02/15/2021,65,3983,54,3115,0.067,11,868,0.019,46591,POINT (-87.756863 41.881113),60644-20210215
60644,02/16/2021,39,4022,30,3145,0.068,9,877,0.019,46591,POINT (-87.756863 41.881113),60644-20210216
60647,01/31/2021,72,7129,57,5517,0.063,15,1612,0.018,87633,POINT (-87.701101 41.921058),60647-20210131
60647,02/01/2021,222,7351,173,5690,0.065,49,1661,0.019,87633,POINT (-87.701101 41.921058),60647-20210201
60642,02/01/2021,67,2717,53,1855,0.094,14,862,0.044,19716,POINT (-87.657821 41.899935),60642-20210201
60643,01/19/2021,128,1804,103,1455,0.03,25,349,0.007,48887,POINT (-87.662381 41.700445),60643-20210119
60643,01/20/2021,147,1951,112,1567,0.032,35,384,0.008,48887,POINT (-87.662381 41.700445),60643-20210120
60643,01/21/2021,181,2132,166,1733,0.035,15,399,0.008,48887,POINT (-87.662381 41.700445),60643-20210121
60643,01/22/2021,200,2332,186,1919,0.039,14,413,0.008,48887,POINT (-87.662381 41.700445),60643-20210122
60643,01/23/2021,107,2439,103,2022,0.041,4,417,0.009,48887,POINT (-87.662381 41.700445),60643-20210123
60643,01/24/2021,31,2470,31,2053,0.042,0,417,0.009,48887,POINT (-87.662381 41.700445),60643-20210124
60643,01/25/2021,124,2594,97,2150,0.044,27,444,0.009,48887,POINT (-87.662381 41.700445),60643-20210125
60643,01/26/2021,164,2758,132,2282,0.047,32,476,0.01,48887,POINT (-87.662381 41.700445),60643-20210126
60643,01/27/2021,235,2993,213,2495,0.051,22,498,0.01,48887,POINT (-87.662381 41.700445),60643-20210127
60643,01/28/2021,256,3249,226,2721,0.056,30,528,0.011,48887,POINT (-87.662381 41.700445),60643-20210128
60605,02/14/2021,32,7511,18,4918,0.169,14,2593,0.089,29060,POINT (-87.623449 41.867824),60605-20210214
60605,02/15/2021,94,7605,61,4979,0.171,33,2626,0.09,29060,POINT (-87.623449 41.867824),60605-20210215
60605,02/16/2021,166,7771,126,5105,0.176,40,2666,0.092,29060,POINT (-87.623449 41.867824),60605-20210216
60643,01/29/2021,232,3481,209,2930,0.06,23,551,0.011,48887,POINT (-87.662381 41.700445),60643-20210129
60643,01/30/2021,137,3618,120,3050,0.062,17,568,0.012,48887,POINT (-87.662381 41.700445),60643-20210130
60643,01/31/2021,39,3657,34,3084,0.063,5,573,0.012,48887,POINT (-87.662381 41.700445),60643-20210131
60644,02/01/2021,76,1997,59,1674,0.036,17,323,0.007,46591,POINT (-87.756863 41.881113),60644-20210201
60649,01/25/2021,106,1879,95,1674,0.036,11,205,0.004,46633,POINT (-87.571522 41.762202),60649-20210125
60649,01/26/2021,213,2092,130,1804,0.039,83,288,0.006,46633,POINT (-87.571522 41.762202),60649-20210126
60649,01/27/2021,122,2214,103,1907,0.041,19,307,0.007,46633,POINT (-87.571522 41.762202),60649-20210127
60649,01/28/2021,136,2350,123,2030,0.044,13,320,0.007,46633,POINT (-87.571522 41.762202),60649-20210128
60605,02/17/2021,167,7938,56,5161,0.178,111,2777,0.096,29060,POINT (-87.623449 41.867824),60605-20210217
60649,01/29/2021,164,2514,144,2174,0.047,20,340,0.007,46633,POINT (-87.571522 41.762202),60649-20210129
60649,01/30/2021,58,2572,52,2226,0.048,6,346,0.007,46633,POINT (-87.571522 41.762202),60649-20210130
60649,01/31/2021,11,2583,11,2237,0.048,0,346,0.007,46633,POINT (-87.571522 41.762202),60649-20210131
60649,02/01/2021,95,2678,81,2318,0.05,14,360,0.008,46633,POINT (-87.571522 41.762202),60649-20210201
60649,02/02/2021,95,2773,66,2384,0.051,29,389,0.008,46633,POINT (-87.571522 41.762202),60649-20210202
60649,02/03/2021,145,2918,118,2502,0.054,27,416,0.009,46633,POINT (-87.571522 41.762202),60649-20210203
60649,02/04/2021,185,3103,153,2655,0.057,32,448,0.01,46633,POINT (-87.571522 41.762202),60649-20210204
60649,02/05/2021,252,3355,120,2775,0.06,132,580,0.012,46633,POINT (-87.571522 41.762202),60649-20210205
60649,02/06/2021,93,3448,65,2840,0.061,28,608,0.013,46633,POINT (-87.571522 41.762202),60649-20210206
60649,02/07/2021,25,3473,21,2861,0.061,4,612,0.013,46633,POINT (-87.571522 41.762202),60649-20210207
60649,02/08/2021,206,3679,97,2958,0.063,109,721,0.015,46633,POINT (-87.571522 41.762202),60649-20210208
60651,02/08/2021,134,3355,113,2845,0.045,21,510,0.008,63492,POINT (-87.741017 41.901964),60651-20210208
60651,02/09/2021,148,3503,114,2959,0.047,34,544,0.009,63492,POINT (-87.741017 41.901964),60651-20210209
60651,02/10/2021,187,3690,138,3097,0.049,49,593,0.009,63492,POINT (-87.741017 41.901964),60651-20210210
60651,02/11/2021,288,3978,203,3300,0.052,85,678,0.011,63492,POINT (-87.741017 41.901964),60651-20210211
60651,02/12/2021,297,4275,209,3509,0.055,88,766,0.012,63492,POINT (-87.741017 41.901964),60651-20210212
60651,02/13/2021,166,4441,129,3638,0.057,37,803,0.013,63492,POINT (-87.741017 41.901964),60651-20210213
60651,02/14/2021,25,4466,22,3660,0.058,3,806,0.013,63492,POINT (-87.741017 41.901964),60651-20210214
60651,02/15/2021,158,4624,123,3783,0.06,35,841,0.013,63492,POINT (-87.741017 41.901964),60651-20210215
60652,02/05/2021,202,2866,192,2275,0.052,10,591,0.014,43447,POINT (-87.714238 41.745398),60652-20210205
60647,01/12/2021,248,2875,136,2102,0.024,112,773,0.009,87633,POINT (-87.701101 41.921058),60647-20210112
60647,01/13/2021,417,3292,315,2417,0.028,102,875,0.01,87633,POINT (-87.701101 41.921058),60647-20210113
60647,01/14/2021,275,3567,241,2658,0.03,34,909,0.01,87633,POINT (-87.701101 41.921058),60647-20210114
60647,01/15/2021,156,3723,136,2794,0.032,20,929,0.011,87633,POINT (-87.701101 41.921058),60647-20210115
60647,01/16/2021,117,3840,107,2901,0.033,10,939,0.011,87633,POINT (-87.701101 41.921058),60647-20210116
60647,01/17/2021,33,3873,24,2925,0.033,9,948,0.011,87633,POINT (-87.701101 41.921058),60647-20210117
60605,02/18/2021,204,8142,84,5245,0.18,120,2897,0.1,29060,POINT (-87.623449 41.867824),60605-20210218
60605,02/19/2021,236,8378,70,5315,0.183,166,3063,0.105,29060,POINT (-87.623449 41.867824),60605-20210219
60605,02/20/2021,81,8459,26,5341,0.184,55,3118,0.107,29060,POINT (-87.623449 41.867824),60605-20210220
60605,02/21/2021,45,8504,9,5350,0.184,36,3154,0.109,29060,POINT (-87.623449 41.867824),60605-20210221
60605,02/22/2021,150,8654,49,5399,0.186,101,3255,0.112,29060,POINT (-87.623449 41.867824),60605-20210222
60605,02/23/2021,175,8829,86,5485,0.189,89,3344,0.115,29060,POINT (-87.623449 41.867824),60605-20210223
60605,02/24/2021,168,8997,65,5550,0.191,103,3447,0.119,29060,POINT (-87.623449 41.867824),60605-20210224
60605,02/25/2021,228,9225,76,5626,0.194,152,3599,0.124,29060,POINT (-87.623449 41.867824),60605-20210225
60605,02/26/2021,264,9489,81,5707,0.196,183,3782,0.13,29060,POINT (-87.623449 41.867824),60605-20210226
60606,03/02/2021,13,1058,5,650,0.198,8,408,0.124,3287,POINT (-87.63676 41.882634),60606-20210302
60606,03/03/2021,25,1083,14,664,0.202,11,419,0.127,3287,POINT (-87.63676 41.882634),60606-20210303
60606,03/04/2021,35,1118,22,686,0.209,13,432,0.131,3287,POINT (-87.63676 41.882634),60606-20210304
60606,03/05/2021,17,1135,9,695,0.211,8,440,0.134,3287,POINT (-87.63676 41.882634),60606-20210305
60647,01/18/2021,135,4008,92,3017,0.034,43,991,0.011,87633,POINT (-87.701101 41.921058),60647-20210118
60647,01/19/2021,198,4206,114,3131,0.036,84,1075,0.012,87633,POINT (-87.701101 41.921058),60647-20210119
60647,01/20/2021,275,4481,182,3313,0.038,93,1168,0.013,87633,POINT (-87.701101 41.921058),60647-20210120
60647,01/21/2021,376,4857,320,3633,0.041,56,1224,0.014,87633,POINT (-87.701101 41.921058),60647-20210121
60647,01/22/2021,297,5154,280,3913,0.045,17,1241,0.014,87633,POINT (-87.701101 41.921058),60647-20210122
60647,01/23/2021,137,5291,124,4037,0.046,13,1254,0.014,87633,POINT (-87.701101 41.921058),60647-20210123
60647,01/24/2021,63,5354,60,4097,0.047,3,1257,0.014,87633,POINT (-87.701101 41.921058),60647-20210124
60647,01/25/2021,196,5550,151,4248,0.048,45,1302,0.015,87633,POINT (-87.701101 41.921058),60647-20210125
60647,01/26/2021,266,5816,185,4433,0.051,81,1383,0.016,87633,POINT (-87.701101 41.921058),60647-20210126
60605,02/27/2021,125,9614,87,5794,0.199,38,3820,0.131,29060,POINT (-87.623449 41.867824),60605-20210227
60605,02/28/2021,67,9681,43,5837,0.201,24,3844,0.132,29060,POINT (-87.623449 41.867824),60605-20210228
60605,03/01/2021,118,9799,60,5897,0.203,58,3902,0.134,29060,POINT (-87.623449 41.867824),60605-20210301
60653,02/05/2021,117,2780,94,2257,0.068,23,523,0.016,33154,POINT (-87.611244 41.819261),60653-20210205
60653,02/06/2021,161,2941,93,2350,0.071,68,591,0.018,33154,POINT (-87.611244 41.819261),60653-20210206
60653,02/07/2021,19,2960,18,2368,0.071,1,592,0.018,33154,POINT (-87.611244 41.819261),60653-20210207
60653,02/08/2021,100,3060,72,2440,0.074,28,620,0.019,33154,POINT (-87.611244 41.819261),60653-20210208
60653,02/09/2021,148,3208,92,2532,0.076,56,676,0.02,33154,POINT (-87.611244 41.819261),60653-20210209
60653,02/10/2021,132,3340,105,2637,0.08,27,703,0.021,33154,POINT (-87.611244 41.819261),60653-20210210
60653,02/11/2021,276,3616,148,2785,0.084,128,831,0.025,33154,POINT (-87.611244 41.819261),60653-20210211
60653,02/12/2021,139,3755,68,2853,0.086,71,902,0.027,33154,POINT (-87.611244 41.819261),60653-20210212
60653,02/13/2021,146,3901,101,2954,0.089,45,947,0.029,33154,POINT (-87.611244 41.819261),60653-20210213
60653,02/14/2021,28,3929,27,2981,0.09,1,948,0.029,33154,POINT (-87.611244 41.819261),60653-20210214
60653,02/15/2021,76,4005,44,3025,0.091,32,980,0.03,33154,POINT (-87.611244 41.819261),60653-20210215
60654,02/04/2021,99,2889,82,1996,0.1,17,893,0.045,20022,POINT (-87.636354 41.892485),60654-20210204
60654,02/05/2021,125,3014,107,2103,0.105,18,911,0.045,20022,POINT (-87.636354 41.892485),60654-20210205
60654,02/06/2021,53,3067,35,2138,0.107,18,929,0.046,20022,POINT (-87.636354 41.892485),60654-20210206
60654,02/07/2021,27,3094,21,2159,0.108,6,935,0.047,20022,POINT (-87.636354 41.892485),60654-20210207
60654,02/08/2021,92,3186,66,2225,0.111,26,961,0.048,20022,POINT (-87.636354 41.892485),60654-20210208
60654,02/09/2021,83,3269,57,2282,0.114,26,987,0.049,20022,POINT (-87.636354 41.892485),60654-20210209
60654,02/10/2021,225,3494,189,2471,0.123,36,1023,0.051,20022,POINT (-87.636354 41.892485),60654-20210210
60654,02/11/2021,106,3600,46,2517,0.126,60,1083,0.054,20022,POINT (-87.636354 41.892485),60654-20210211
60651,02/01/2021,100,2074,85,1753,0.028,15,321,0.005,63492,POINT (-87.741017 41.901964),60651-20210201
60652,01/27/2021,136,1666,116,1273,0.029,20,393,0.009,43447,POINT (-87.714238 41.745398),60652-20210127
60652,01/28/2021,135,1801,108,1381,0.032,27,420,0.01,43447,POINT (-87.714238 41.745398),60652-20210128
60652,01/29/2021,136,1937,111,1492,0.034,25,445,0.01,43447,POINT (-87.714238 41.745398),60652-20210129
60652,01/30/2021,79,2016,67,1559,0.036,12,457,0.011,43447,POINT (-87.714238 41.745398),60652-20210130
60652,01/31/2021,11,2027,7,1566,0.036,4,461,0.011,43447,POINT (-87.714238 41.745398),60652-20210131
60652,02/01/2021,106,2133,90,1656,0.038,16,477,0.011,43447,POINT (-87.714238 41.745398),60652-20210201
60657,01/19/2021,234,6076,104,4360,0.061,130,1716,0.024,70958,POINT (-87.658216 41.939715),60657-20210119
60657,01/20/2021,335,6411,178,4538,0.064,157,1873,0.026,70958,POINT (-87.658216 41.939715),60657-20210120
60657,01/21/2021,361,6772,288,4826,0.068,73,1946,0.027,70958,POINT (-87.658216 41.939715),60657-20210121
60657,01/22/2021,351,7123,307,5133,0.072,44,1990,0.028,70958,POINT (-87.658216 41.939715),60657-20210122
60657,01/23/2021,184,7307,161,5294,0.075,23,2013,0.028,70958,POINT (-87.658216 41.939715),60657-20210123
60653,01/13/2021,50,850,29,699,0.021,21,151,0.005,33154,POINT (-87.611244 41.819261),60653-20210113
60653,01/14/2021,69,919,61,760,0.023,8,159,0.005,33154,POINT (-87.611244 41.819261),60653-20210114
60653,01/15/2021,27,946,22,782,0.024,5,164,0.005,33154,POINT (-87.611244 41.819261),60653-20210115
60653,01/16/2021,12,958,10,792,0.024,2,166,0.005,33154,POINT (-87.611244 41.819261),60653-20210116
60653,01/17/2021,6,964,2,794,0.024,4,170,0.005,33154,POINT (-87.611244 41.819261),60653-20210117
60653,01/18/2021,38,1002,24,818,0.025,14,184,0.006,33154,POINT (-87.611244 41.819261),60653-20210118
60653,01/19/2021,91,1093,69,887,0.027,22,206,0.006,33154,POINT (-87.611244 41.819261),60653-20210119
60653,01/20/2021,62,1155,38,925,0.028,24,230,0.007,33154,POINT (-87.611244 41.819261),60653-20210120
60653,01/21/2021,86,1241,73,998,0.03,13,243,0.007,33154,POINT (-87.611244 41.819261),60653-20210121
60653,01/22/2021,110,1351,103,1101,0.033,7,250,0.008,33154,POINT (-87.611244 41.819261),60653-20210122
60653,01/23/2021,62,1413,60,1161,0.035,2,252,0.008,33154,POINT (-87.611244 41.819261),60653-20210123
60653,01/24/2021,18,1431,18,1179,0.036,0,252,0.008,33154,POINT (-87.611244 41.819261),60653-20210124
60653,01/25/2021,85,1516,68,1247,0.038,17,269,0.008,33154,POINT (-87.611244 41.819261),60653-20210125
60653,01/26/2021,99,1615,77,1324,0.04,22,291,0.009,33154,POINT (-87.611244 41.819261),60653-20210126
60653,01/27/2021,218,1833,125,1449,0.044,93,384,0.012,33154,POINT (-87.611244 41.819261),60653-20210127
60653,01/28/2021,117,1950,105,1554,0.047,12,396,0.012,33154,POINT (-87.611244 41.819261),60653-20210128
60653,01/29/2021,186,2136,173,1727,0.052,13,409,0.012,33154,POINT (-87.611244 41.819261),60653-20210129
60653,01/30/2021,51,2187,43,1770,0.053,8,417,0.013,33154,POINT (-87.611244 41.819261),60653-20210130
60653,01/31/2021,8,2195,7,1777,0.054,1,418,0.013,33154,POINT (-87.611244 41.819261),60653-20210131
60653,02/01/2021,66,2261,53,1830,0.055,13,431,0.013,33154,POINT (-87.611244 41.819261),60653-20210201
60653,02/02/2021,108,2369,76,1906,0.057,32,463,0.014,33154,POINT (-87.611244 41.819261),60653-20210202
60653,02/03/2021,108,2477,91,1997,0.06,17,480,0.014,33154,POINT (-87.611244 41.819261),60653-20210203
60653,02/04/2021,186,2663,166,2163,0.065,20,500,0.015,33154,POINT (-87.611244 41.819261),60653-20210204
60657,01/24/2021,71,7378,61,5355,0.075,10,2023,0.029,70958,POINT (-87.658216 41.939715),60657-20210124
60657,01/25/2021,269,7647,200,5555,0.078,69,2092,0.029,70958,POINT (-87.658216 41.939715),60657-20210125
60657,01/26/2021,349,7996,196,5751,0.081,153,2245,0.032,70958,POINT (-87.658216 41.939715),60657-20210126
60657,01/27/2021,304,8300,208,5959,0.084,96,2341,0.033,70958,POINT (-87.658216 41.939715),60657-20210127
60657,01/28/2021,395,8695,314,6273,0.088,81,2422,0.034,70958,POINT (-87.658216 41.939715),60657-20210128
60657,01/29/2021,379,9074,337,6610,0.093,42,2464,0.035,70958,POINT (-87.658216 41.939715),60657-20210129
60657,01/30/2021,178,9252,128,6738,0.095,50,2514,0.035,70958,POINT (-87.658216 41.939715),60657-20210130
60657,01/31/2021,73,9325,60,6798,0.096,13,2527,0.036,70958,POINT (-87.658216 41.939715),60657-20210131
60657,02/01/2021,274,9599,156,6954,0.098,118,2645,0.037,70958,POINT (-87.658216 41.939715),60657-20210201
60657,02/02/2021,399,9998,244,7198,0.101,155,2800,0.039,70958,POINT (-87.658216 41.939715),60657-20210202
60657,02/03/2021,361,10359,264,7462,0.105,97,2897,0.041,70958,POINT (-87.658216 41.939715),60657-20210203
60657,02/04/2021,413,10772,332,7794,0.11,81,2978,0.042,70958,POINT (-87.658216 41.939715),60657-20210204
60657,02/05/2021,534,11306,404,8198,0.116,130,3108,0.044,70958,POINT (-87.658216 41.939715),60657-20210205
60657,02/08/2021,275,12213,201,8831,0.124,74,3382,0.048,70958,POINT (-87.658216 41.939715),60657-20210208
60654,12/15/2020,0,0,0,0,0,0,0,0,20022,POINT (-87.636354 41.892485),60654-20201215
60654,12/16/2020,5,5,5,5,0,0,0,0,20022,POINT (-87.636354 41.892485),60654-20201216
60654,12/17/2020,70,75,70,75,0.004,0,0,0,20022,POINT (-87.636354 41.892485),60654-20201217
60654,12/18/2020,136,211,136,211,0.011,0,0,0,20022,POINT (-87.636354 41.892485),60654-20201218
60654,12/19/2020,81,292,81,292,0.015,0,0,0,20022,POINT (-87.636354 41.892485),60654-20201219
60654,12/20/2020,14,306,14,306,0.015,0,0,0,20022,POINT (-87.636354 41.892485),60654-20201220
60654,12/21/2020,95,401,95,401,0.02,0,0,0,20022,POINT (-87.636354 41.892485),60654-20201221
60654,12/22/2020,82,483,82,483,0.024,0,0,0,20022,POINT (-87.636354 41.892485),60654-20201222
60654,12/23/2020,36,519,36,519,0.026,0,0,0,20022,POINT (-87.636354 41.892485),60654-20201223
60654,12/24/2020,10,529,10,529,0.026,0,0,0,20022,POINT (-87.636354 41.892485),60654-20201224
60654,12/25/2020,0,529,0,529,0.026,0,0,0,20022,POINT (-87.636354 41.892485),60654-20201225
60654,12/26/2020,17,546,17,546,0.027,0,0,0,20022,POINT (-87.636354 41.892485),60654-20201226
60654,12/27/2020,0,546,0,546,0.027,0,0,0,20022,POINT (-87.636354 41.892485),60654-20201227
60654,12/28/2020,27,573,27,573,0.029,0,0,0,20022,POINT (-87.636354 41.892485),60654-20201228
60654,12/29/2020,48,621,48,621,0.031,0,0,0,20022,POINT (-87.636354 41.892485),60654-20201229
60654,12/30/2020,33,654,33,654,0.033,0,0,0,20022,POINT (-87.636354 41.892485),60654-20201230
60654,12/31/2020,12,666,12,666,0.033,0,0,0,20022,POINT (-87.636354 41.892485),60654-20201231
60654,01/01/2021,1,667,1,667,0.033,0,0,0,20022,POINT (-87.636354 41.892485),60654-20210101
60654,01/02/2021,14,681,14,681,0.034,0,0,0,20022,POINT (-87.636354 41.892485),60654-20210102
60654,01/03/2021,9,690,9,690,0.034,0,0,0,20022,POINT (-87.636354 41.892485),60654-20210103
60654,01/04/2021,27,717,24,714,0.036,3,3,0,20022,POINT (-87.636354 41.892485),60654-20210104
60654,01/05/2021,47,764,40,754,0.038,7,10,0,20022,POINT (-87.636354 41.892485),60654-20210105
60654,01/06/2021,40,804,23,777,0.039,17,27,0.001,20022,POINT (-87.636354 41.892485),60654-20210106
60654,01/07/2021,109,913,28,805,0.04,81,108,0.005,20022,POINT (-87.636354 41.892485),60654-20210107
60654,01/08/2021,151,1064,34,839,0.042,117,225,0.011,20022,POINT (-87.636354 41.892485),60654-20210108
60654,01/09/2021,79,1143,13,852,0.043,66,291,0.015,20022,POINT (-87.636354 41.892485),60654-20210109
60654,01/10/2021,20,1163,6,858,0.043,14,305,0.015,20022,POINT (-87.636354 41.892485),60654-20210110
60654,01/11/2021,108,1271,22,880,0.044,86,391,0.02,20022,POINT (-87.636354 41.892485),60654-20210111
60654,01/12/2021,117,1388,39,919,0.046,78,469,0.023,20022,POINT (-87.636354 41.892485),60654-20210112
60654,01/13/2021,71,1459,34,953,0.048,37,506,0.025,20022,POINT (-87.636354 41.892485),60654-20210113
60654,01/14/2021,33,1492,24,977,0.049,9,515,0.026,20022,POINT (-87.636354 41.892485),60654-20210114
60654,01/15/2021,44,1536,36,1013,0.051,8,523,0.026,20022,POINT (-87.636354 41.892485),60654-20210115
60654,01/16/2021,33,1569,24,1037,0.052,9,532,0.027,20022,POINT (-87.636354 41.892485),60654-20210116
60654,01/17/2021,19,1588,8,1045,0.052,11,543,0.027,20022,POINT (-87.636354 41.892485),60654-20210117
60654,01/18/2021,46,1634,25,1070,0.053,21,564,0.028,20022,POINT (-87.636354 41.892485),60654-20210118
60654,01/19/2021,69,1703,29,1099,0.055,40,604,0.03,20022,POINT (-87.636354 41.892485),60654-20210119
60654,01/20/2021,61,1764,41,1140,0.057,20,624,0.031,20022,POINT (-87.636354 41.892485),60654-20210120
60654,01/21/2021,93,1857,77,1217,0.061,16,640,0.032,20022,POINT (-87.636354 41.892485),60654-20210121
60654,01/22/2021,97,1954,81,1298,0.065,16,656,0.033,20022,POINT (-87.636354 41.892485),60654-20210122
60654,01/23/2021,53,2007,48,1346,0.067,5,661,0.033,20022,POINT (-87.636354 41.892485),60654-20210123
60654,01/24/2021,21,2028,20,1366,0.068,1,662,0.033,20022,POINT (-87.636354 41.892485),60654-20210124
60654,01/25/2021,78,2106,64,1430,0.071,14,676,0.034,20022,POINT (-87.636354 41.892485),60654-20210125
60654,01/26/2021,84,2190,42,1472,0.074,42,718,0.036,20022,POINT (-87.636354 41.892485),60654-20210126
60654,01/27/2021,70,2260,54,1526,0.076,16,734,0.037,20022,POINT (-87.636354 41.892485),60654-20210127
60654,01/28/2021,119,2379,83,1609,0.08,36,770,0.038,20022,POINT (-87.636354 41.892485),60654-20210128
60654,01/29/2021,87,2466,75,1684,0.084,12,782,0.039,20022,POINT (-87.636354 41.892485),60654-20210129
60654,01/30/2021,52,2518,40,1724,0.086,12,794,0.04,20022,POINT (-87.636354 41.892485),60654-20210130
60654,01/31/2021,30,2548,26,1750,0.087,4,798,0.04,20022,POINT (-87.636354 41.892485),60654-20210131
60654,02/01/2021,51,2599,40,1790,0.089,11,809,0.04,20022,POINT (-87.636354 41.892485),60654-20210201
60654,02/02/2021,113,2712,71,1861,0.093,42,851,0.043,20022,POINT (-87.636354 41.892485),60654-20210202
60659,01/05/2021,66,591,65,590,0.014,1,1,0,42735,POINT (-87.703266 41.990803),60659-20210105
60655,01/08/2021,101,998,20,802,0.028,81,196,0.007,28569,POINT (-87.701434 41.696456),60655-20210108
60655,01/09/2021,41,1039,4,806,0.028,37,233,0.008,28569,POINT (-87.701434 41.696456),60655-20210109
60655,01/10/2021,25,1064,3,809,0.028,22,255,0.009,28569,POINT (-87.701434 41.696456),60655-20210110
60655,01/11/2021,79,1143,27,836,0.029,52,307,0.011,28569,POINT (-87.701434 41.696456),60655-20210111
60655,01/12/2021,53,1196,25,861,0.03,28,335,0.012,28569,POINT (-87.701434 41.696456),60655-20210112
60655,01/13/2021,124,1320,105,966,0.034,19,354,0.012,28569,POINT (-87.701434 41.696456),60655-20210113
60655,01/14/2021,91,1411,77,1043,0.037,14,368,0.013,28569,POINT (-87.701434 41.696456),60655-20210114
60660,02/01/2021,150,4346,116,3527,0.079,34,819,0.018,44498,POINT (-87.666362 41.991062),60660-20210201
60660,02/02/2021,186,4532,125,3652,0.082,61,880,0.02,44498,POINT (-87.666362 41.991062),60660-20210202
60660,02/03/2021,261,4793,146,3798,0.085,115,995,0.022,44498,POINT (-87.666362 41.991062),60660-20210203
60660,02/04/2021,589,5382,267,4065,0.091,322,1317,0.03,44498,POINT (-87.666362 41.991062),60660-20210204
60660,02/05/2021,521,5903,263,4328,0.097,258,1575,0.035,44498,POINT (-87.666362 41.991062),60660-20210205
60666,03/05/2021,0,36,0,24,0,0,12,0,0,POINT (-87.896371 41.979511),60666-20210305
60659,01/04/2021,72,525,72,525,0.012,0,0,0,42735,POINT (-87.703266 41.990803),60659-20210104
60659,12/15/2020,0,0,0,0,0,0,0,0,42735,POINT (-87.703266 41.990803),60659-20201215
60659,12/16/2020,2,2,2,2,0,0,0,0,42735,POINT (-87.703266 41.990803),60659-20201216
60659,12/17/2020,14,16,14,16,0,0,0,0,42735,POINT (-87.703266 41.990803),60659-20201217
60659,12/18/2020,44,60,44,60,0.001,0,0,0,42735,POINT (-87.703266 41.990803),60659-20201218
60659,12/19/2020,32,92,32,92,0.002,0,0,0,42735,POINT (-87.703266 41.990803),60659-20201219
60659,12/20/2020,7,99,7,99,0.002,0,0,0,42735,POINT (-87.703266 41.990803),60659-20201220
60659,12/21/2020,61,160,61,160,0.004,0,0,0,42735,POINT (-87.703266 41.990803),60659-20201221
60659,12/22/2020,36,196,36,196,0.005,0,0,0,42735,POINT (-87.703266 41.990803),60659-20201222
60659,12/23/2020,41,237,41,237,0.006,0,0,0,42735,POINT (-87.703266 41.990803),60659-20201223
60659,12/24/2020,9,246,9,246,0.006,0,0,0,42735,POINT (-87.703266 41.990803),60659-20201224
60659,12/25/2020,0,246,0,246,0.006,0,0,0,42735,POINT (-87.703266 41.990803),60659-20201225
60659,12/26/2020,4,250,4,250,0.006,0,0,0,42735,POINT (-87.703266 41.990803),60659-20201226
60659,12/27/2020,2,252,2,252,0.006,0,0,0,42735,POINT (-87.703266 41.990803),60659-20201227
60659,12/28/2020,28,280,28,280,0.007,0,0,0,42735,POINT (-87.703266 41.990803),60659-20201228
60659,12/29/2020,58,338,58,338,0.008,0,0,0,42735,POINT (-87.703266 41.990803),60659-20201229
60659,12/30/2020,45,383,45,383,0.009,0,0,0,42735,POINT (-87.703266 41.990803),60659-20201230
60659,12/31/2020,32,415,32,415,0.01,0,0,0,42735,POINT (-87.703266 41.990803),60659-20201231
60659,01/01/2021,2,417,2,417,0.01,0,0,0,42735,POINT (-87.703266 41.990803),60659-20210101
60659,01/02/2021,13,430,13,430,0.01,0,0,0,42735,POINT (-87.703266 41.990803),60659-20210102
60659,01/03/2021,23,453,23,453,0.011,0,0,0,42735,POINT (-87.703266 41.990803),60659-20210103
60608,02/05/2021,411,7377,350,5924,0.074,61,1453,0.018,80059,POINT (-87.670366 41.849879),60608-20210205
60608,02/06/2021,329,7706,218,6142,0.077,111,1564,0.02,80059,POINT (-87.670366 41.849879),60608-20210206
60608,02/07/2021,144,7850,83,6225,0.078,61,1625,0.02,80059,POINT (-87.670366 41.849879),60608-20210207
60608,02/08/2021,266,8116,214,6439,0.08,52,1677,0.021,80059,POINT (-87.670366 41.849879),60608-20210208
60608,02/09/2021,332,8448,266,6705,0.084,66,1743,0.022,80059,POINT (-87.670366 41.849879),60608-20210209
60608,02/10/2021,474,8922,359,7064,0.088,115,1858,0.023,80059,POINT (-87.670366 41.849879),60608-20210210
60608,02/11/2021,507,9429,303,7367,0.092,204,2062,0.026,80059,POINT (-87.670366 41.849879),60608-20210211
60608,02/12/2021,416,9845,242,7609,0.095,174,2236,0.028,80059,POINT (-87.670366 41.849879),60608-20210212
60608,02/13/2021,254,10099,156,7765,0.097,98,2334,0.029,80059,POINT (-87.670366 41.849879),60608-20210213
60608,02/14/2021,38,10137,24,7789,0.097,14,2348,0.029,80059,POINT (-87.670366 41.849879),60608-20210214
60608,02/15/2021,241,10378,204,7993,0.1,37,2385,0.03,80059,POINT (-87.670366 41.849879),60608-20210215
60608,02/16/2021,206,10584,149,8142,0.102,57,2442,0.031,80059,POINT (-87.670366 41.849879),60608-20210216
60603,03/05/2021,9,763,9,482,0.458,0,281,0.267,1052,POINT (-87.625473 41.880112),60603-20210305
60604,03/05/2021,7,506,3,306,0.372,4,200,0.243,823,POINT (-87.629029 41.878153),60604-20210305
60608,02/17/2021,486,11070,251,8393,0.105,235,2677,0.033,80059,POINT (-87.670366 41.849879),60608-20210217
60608,02/18/2021,361,11431,208,8601,0.107,153,2830,0.035,80059,POINT (-87.670366 41.849879),60608-20210218
60608,02/19/2021,374,11805,189,8790,0.11,185,3015,0.038,80059,POINT (-87.670366 41.849879),60608-20210219
60608,02/20/2021,248,12053,120,8910,0.111,128,3143,0.039,80059,POINT (-87.670366 41.849879),60608-20210220
60608,02/21/2021,57,12110,17,8927,0.112,40,3183,0.04,80059,POINT (-87.670366 41.849879),60608-20210221
60608,02/22/2021,424,12534,202,9129,0.114,222,3405,0.043,80059,POINT (-87.670366 41.849879),60608-20210222
Unknown,03/05/2021,60,2317,43,1439,0,17,878,0,0,,Unknown-20210305
60605,03/05/2021,220,10630,146,6352,0.219,74,4278,0.147,29060,POINT (-87.623449 41.867824),60605-20210305
60608,02/23/2021,408,12942,171,9300,0.116,237,3642,0.045,80059,POINT (-87.670366 41.849879),60608-20210223
60608,02/24/2021,528,13470,261,9561,0.119,267,3909,0.049,80059,POINT (-87.670366 41.849879),60608-20210224
60608,02/25/2021,592,14062,260,9821,0.123,332,4241,0.053,80059,POINT (-87.670366 41.849879),60608-20210225
60608,02/26/2021,592,14654,279,10100,0.126,313,4554,0.057,80059,POINT (-87.670366 41.849879),60608-20210226
60608,02/27/2021,430,15084,277,10377,0.13,153,4707,0.059,80059,POINT (-87.670366 41.849879),60608-20210227
60608,02/28/2021,91,15175,50,10427,0.13,41,4748,0.059,80059,POINT (-87.670366 41.849879),60608-20210228
60608,03/01/2021,425,15600,179,10606,0.132,246,4994,0.062,80059,POINT (-87.670366 41.849879),60608-20210301
60608,03/02/2021,486,16086,218,10824,0.135,268,5262,0.066,80059,POINT (-87.670366 41.849879),60608-20210302
60608,03/03/2021,541,16627,232,11056,0.138,309,5571,0.07,80059,POINT (-87.670366 41.849879),60608-20210303
60608,03/05/2021,538,17606,352,11655,0.146,186,5951,0.074,80059,POINT (-87.670366 41.849879),60608-20210305
60609,02/17/2021,217,5756,125,4506,0.074,92,1250,0.021,60939,POINT (-87.653382 41.812017),60609-20210217
60609,02/06/2021,112,3670,84,2983,0.049,28,687,0.011,60939,POINT (-87.653382 41.812017),60609-20210206
60609,02/07/2021,27,3697,25,3008,0.049,2,689,0.011,60939,POINT (-87.653382 41.812017),60609-20210207
60609,02/08/2021,179,3876,152,3160,0.052,27,716,0.012,60939,POINT (-87.653382 41.812017),60609-20210208
60609,02/09/2021,171,4047,145,3305,0.054,26,742,0.012,60939,POINT (-87.653382 41.812017),60609-20210209
60609,02/10/2021,309,4356,259,3564,0.058,50,792,0.013,60939,POINT (-87.653382 41.812017),60609-20210210
60609,02/11/2021,297,4653,205,3769,0.062,92,884,0.015,60939,POINT (-87.653382 41.812017),60609-20210211
60609,02/12/2021,274,4927,197,3966,0.065,77,961,0.016,60939,POINT (-87.653382 41.812017),60609-20210212
60609,02/13/2021,254,5181,141,4107,0.067,113,1074,0.018,60939,POINT (-87.653382 41.812017),60609-20210213
60609,02/14/2021,33,5214,23,4130,0.068,10,1084,0.018,60939,POINT (-87.653382 41.812017),60609-20210214
60609,02/15/2021,188,5402,151,4281,0.07,37,1121,0.018,60939,POINT (-87.653382 41.812017),60609-20210215
60609,02/16/2021,137,5539,100,4381,0.072,37,1158,0.019,60939,POINT (-87.653382 41.812017),60609-20210216
60610,02/24/2021,197,10011,91,6555,0.162,106,3456,0.085,40548,POINT (-87.63581 41.90455),60610-20210224
60610,02/25/2021,380,10391,111,6666,0.164,269,3725,0.092,40548,POINT (-87.63581 41.90455),60610-20210225
60610,02/26/2021,520,10911,208,6874,0.17,312,4037,0.1,40548,POINT (-87.63581 41.90455),60610-20210226
60666,03/02/2021,3,36,1,24,0,2,12,0,0,POINT (-87.896371 41.979511),60666-20210302
60707,01/25/2021,13,612,10,503,0.012,3,109,0.003,43093,POINT (-87.808283 41.921777),60707-20210125
60707,01/26/2021,29,641,20,523,0.012,9,118,0.003,43093,POINT (-87.808283 41.921777),60707-20210126
60707,01/27/2021,49,690,39,562,0.013,10,128,0.003,43093,POINT (-87.808283 41.921777),60707-20210127
60707,01/28/2021,55,745,49,611,0.014,6,134,0.003,43093,POINT (-87.808283 41.921777),60707-20210128
60707,01/29/2021,50,795,45,656,0.015,5,139,0.003,43093,POINT (-87.808283 41.921777),60707-20210129
60707,01/30/2021,39,834,35,691,0.016,4,143,0.003,43093,POINT (-87.808283 41.921777),60707-20210130
60707,01/31/2021,8,842,7,698,0.016,1,144,0.003,43093,POINT (-87.808283 41.921777),60707-20210131
60707,02/01/2021,39,881,31,729,0.017,8,152,0.004,43093,POINT (-87.808283 41.921777),60707-20210201
60707,02/02/2021,69,950,48,777,0.018,21,173,0.004,43093,POINT (-87.808283 41.921777),60707-20210202
60707,02/03/2021,65,1015,54,831,0.019,11,184,0.004,43093,POINT (-87.808283 41.921777),60707-20210203
60707,02/04/2021,79,1094,72,903,0.021,7,191,0.004,43093,POINT (-87.808283 41.921777),60707-20210204
60707,02/05/2021,75,1169,54,957,0.022,21,212,0.005,43093,POINT (-87.808283 41.921777),60707-20210205
60707,02/06/2021,61,1230,49,1006,0.023,12,224,0.005,43093,POINT (-87.808283 41.921777),60707-20210206
60707,02/07/2021,6,1236,5,1011,0.023,1,225,0.005,43093,POINT (-87.808283 41.921777),60707-20210207
60707,02/08/2021,58,1294,54,1065,0.025,4,229,0.005,43093,POINT (-87.808283 41.921777),60707-20210208
60707,02/09/2021,69,1363,56,1121,0.026,13,242,0.006,43093,POINT (-87.808283 41.921777),60707-20210209
60707,02/10/2021,97,1460,80,1201,0.028,17,259,0.006,43093,POINT (-87.808283 41.921777),60707-20210210
60707,02/11/2021,98,1558,63,1264,0.029,35,294,0.007,43093,POINT (-87.808283 41.921777),60707-20210211
60707,02/12/2021,95,1653,54,1318,0.031,41,335,0.008,43093,POINT (-87.808283 41.921777),60707-20210212
60707,02/13/2021,83,1736,55,1373,0.032,28,363,0.008,43093,POINT (-87.808283 41.921777),60707-20210213
60707,02/14/2021,16,1752,15,1388,0.032,1,364,0.008,43093,POINT (-87.808283 41.921777),60707-20210214
60707,02/15/2021,30,1782,26,1414,0.033,4,368,0.009,43093,POINT (-87.808283 41.921777),60707-20210215
60609,02/24/2021,219,7069,116,5241,0.086,103,1828,0.03,60939,POINT (-87.653382 41.812017),60609-20210224
60609,02/25/2021,313,7382,145,5386,0.088,168,1996,0.033,60939,POINT (-87.653382 41.812017),60609-20210225
60611,02/09/2021,184,10618,130,7194,0.217,54,3424,0.103,33224,POINT (-87.620291 41.894734),60611-20210209
60611,02/10/2021,353,10971,294,7488,0.225,59,3483,0.105,33224,POINT (-87.620291 41.894734),60611-20210210
60611,02/11/2021,466,11437,111,7599,0.229,355,3838,0.116,33224,POINT (-87.620291 41.894734),60611-20210211
60611,02/12/2021,518,11955,138,7737,0.233,380,4218,0.127,33224,POINT (-87.620291 41.894734),60611-20210212
60611,02/13/2021,149,12104,62,7799,0.235,87,4305,0.13,33224,POINT (-87.620291 41.894734),60611-20210213
60611,02/14/2021,44,12148,34,7833,0.236,10,4315,0.13,33224,POINT (-87.620291 41.894734),60611-20210214
60611,02/15/2021,121,12269,63,7896,0.238,58,4373,0.132,33224,POINT (-87.620291 41.894734),60611-20210215
60611,02/16/2021,295,12564,244,8140,0.245,51,4424,0.133,33224,POINT (-87.620291 41.894734),60611-20210216
60611,02/17/2021,239,12803,80,8220,0.247,159,4583,0.138,33224,POINT (-87.620291 41.894734),60611-20210217
60611,02/18/2021,452,13255,139,8359,0.252,313,4896,0.147,33224,POINT (-87.620291 41.894734),60611-20210218
60611,02/19/2021,417,13672,68,8427,0.254,349,5245,0.158,33224,POINT (-87.620291 41.894734),60611-20210219
60666,03/03/2021,0,36,0,24,0,0,12,0,0,POINT (-87.896371 41.979511),60666-20210303
60612,02/05/2021,200,4426,142,3146,0.093,58,1280,0.038,33735,POINT (-87.687011 41.88004),60612-20210205
60612,02/06/2021,74,4500,49,3195,0.095,25,1305,0.039,33735,POINT (-87.687011 41.88004),60612-20210206
60612,02/07/2021,23,4523,15,3210,0.095,8,1313,0.039,33735,POINT (-87.687011 41.88004),60612-20210207
60612,02/08/2021,100,4623,77,3287,0.097,23,1336,0.04,33735,POINT (-87.687011 41.88004),60612-20210208
60612,02/09/2021,132,4755,95,3382,0.1,37,1373,0.041,33735,POINT (-87.687011 41.88004),60612-20210209
60612,02/10/2021,152,4907,87,3469,0.103,65,1438,0.043,33735,POINT (-87.687011 41.88004),60612-20210210
60612,02/11/2021,243,5150,116,3585,0.106,127,1565,0.046,33735,POINT (-87.687011 41.88004),60612-20210211
60612,02/12/2021,223,5373,129,3714,0.11,94,1659,0.049,33735,POINT (-87.687011 41.88004),60612-20210212
60612,02/13/2021,106,5479,72,3786,0.112,34,1693,0.05,33735,POINT (-87.687011 41.88004),60612-20210213
60612,02/14/2021,10,5489,8,3794,0.112,2,1695,0.05,33735,POINT (-87.687011 41.88004),60612-20210214
60612,02/15/2021,83,5572,62,3856,0.114,21,1716,0.051,33735,POINT (-87.687011 41.88004),60612-20210215
60612,02/16/2021,63,5635,44,3900,0.116,19,1735,0.051,33735,POINT (-87.687011 41.88004),60612-20210216
60612,02/17/2021,217,5852,100,4000,0.119,117,1852,0.055,33735,POINT (-87.687011 41.88004),60612-20210217
60612,02/18/2021,319,6171,199,4199,0.124,120,1972,0.058,33735,POINT (-87.687011 41.88004),60612-20210218
60601,02/02/2021,57,1950,34,1406,0.093,23,544,0.036,15083,POINT (-87.622844 41.886262),60601-20210202
60601,02/03/2021,68,2018,51,1457,0.097,17,561,0.037,15083,POINT (-87.622844 41.886262),60601-20210203
60601,02/04/2021,114,2132,96,1553,0.103,18,579,0.038,15083,POINT (-87.622844 41.886262),60601-20210204
60601,02/05/2021,121,2253,104,1657,0.11,17,596,0.04,15083,POINT (-87.622844 41.886262),60601-20210205
60601,02/06/2021,35,2288,19,1676,0.111,16,612,0.041,15083,POINT (-87.622844 41.886262),60601-20210206
60601,02/07/2021,20,2308,17,1693,0.112,3,615,0.041,15083,POINT (-87.622844 41.886262),60601-20210207
60601,02/08/2021,50,2358,37,1730,0.115,13,628,0.042,15083,POINT (-87.622844 41.886262),60601-20210208
60601,02/09/2021,48,2406,28,1758,0.117,20,648,0.043,15083,POINT (-87.622844 41.886262),60601-20210209
60601,02/10/2021,109,2515,83,1841,0.122,26,674,0.045,15083,POINT (-87.622844 41.886262),60601-20210210
60601,02/11/2021,138,2653,52,1893,0.126,86,760,0.05,15083,POINT (-87.622844 41.886262),60601-20210211
60601,02/12/2021,133,2786,38,1931,0.128,95,855,0.057,15083,POINT (-87.622844 41.886262),60601-20210212
60601,02/13/2021,47,2833,26,1957,0.13,21,876,0.058,15083,POINT (-87.622844 41.886262),60601-20210213
60601,02/14/2021,16,2849,7,1964,0.13,9,885,0.059,15083,POINT (-87.622844 41.886262),60601-20210214
60612,02/19/2021,165,6336,87,4286,0.127,78,2050,0.061,33735,POINT (-87.687011 41.88004),60612-20210219
60612,02/20/2021,69,6405,22,4308,0.128,47,2097,0.062,33735,POINT (-87.687011 41.88004),60612-20210220
60612,02/21/2021,12,6417,6,4314,0.128,6,2103,0.062,33735,POINT (-87.687011 41.88004),60612-20210221
60612,02/22/2021,125,6542,50,4364,0.129,75,2178,0.065,33735,POINT (-87.687011 41.88004),60612-20210222
60612,02/23/2021,145,6687,55,4419,0.131,90,2268,0.067,33735,POINT (-87.687011 41.88004),60612-20210223
60612,02/24/2021,202,6889,87,4506,0.134,115,2383,0.071,33735,POINT (-87.687011 41.88004),60612-20210224
60612,02/25/2021,226,7115,95,4601,0.136,131,2514,0.075,33735,POINT (-87.687011 41.88004),60612-20210225
60612,02/26/2021,260,7375,78,4679,0.139,182,2696,0.08,33735,POINT (-87.687011 41.88004),60612-20210226
60612,02/27/2021,109,7484,61,4740,0.141,48,2744,0.081,33735,POINT (-87.687011 41.88004),60612-20210227
60612,02/28/2021,33,7517,12,4752,0.141,21,2765,0.082,33735,POINT (-87.687011 41.88004),60612-20210228
60612,03/01/2021,119,7636,58,4810,0.143,61,2826,0.084,33735,POINT (-87.687011 41.88004),60612-20210301
60612,03/02/2021,148,7784,80,4890,0.145,68,2894,0.086,33735,POINT (-87.687011 41.88004),60612-20210302
60612,03/03/2021,194,7978,99,4989,0.148,95,2989,0.089,33735,POINT (-87.687011 41.88004),60612-20210303
60612,03/04/2021,160,8138,89,5078,0.151,71,3060,0.091,33735,POINT (-87.687011 41.88004),60612-20210304
60612,03/05/2021,156,8294,88,5166,0.153,68,3128,0.093,33735,POINT (-87.687011 41.88004),60612-20210305
60601,02/15/2021,24,2873,19,1983,0.131,5,890,0.059,15083,POINT (-87.622844 41.886262),60601-20210215
60601,02/16/2021,75,2948,64,2047,0.136,11,901,0.06,15083,POINT (-87.622844 41.886262),60601-20210216
60601,02/17/2021,82,3030,32,2079,0.138,50,951,0.063,15083,POINT (-87.622844 41.886262),60601-20210217
60601,02/18/2021,112,3142,48,2127,0.141,64,1015,0.067,15083,POINT (-87.622844 41.886262),60601-20210218
60601,02/19/2021,114,3256,19,2146,0.142,95,1110,0.074,15083,POINT (-87.622844 41.886262),60601-20210219
60601,02/20/2021,41,3297,11,2157,0.143,30,1140,0.076,15083,POINT (-87.622844 41.886262),60601-20210220
60601,02/21/2021,13,3310,2,2159,0.143,11,1151,0.076,15083,POINT (-87.622844 41.886262),60601-20210221
60602,02/03/2021,21,332,17,262,0.229,4,70,0.061,1145,POINT (-87.628309 41.883136),60602-20210203
60602,02/04/2021,19,351,17,279,0.244,2,72,0.063,1145,POINT (-87.628309 41.883136),60602-20210204
60602,02/05/2021,13,364,12,291,0.254,1,73,0.064,1145,POINT (-87.628309 41.883136),60602-20210205
60602,02/06/2021,8,372,3,294,0.257,5,78,0.068,1145,POINT (-87.628309 41.883136),60602-20210206
60602,02/07/2021,2,374,1,295,0.258,1,79,0.069,1145,POINT (-87.628309 41.883136),60602-20210207
60602,02/08/2021,10,384,7,302,0.264,3,82,0.072,1145,POINT (-87.628309 41.883136),60602-20210208
60602,02/09/2021,11,395,2,304,0.266,9,91,0.079,1145,POINT (-87.628309 41.883136),60602-20210209
60602,02/10/2021,15,410,10,314,0.274,5,96,0.084,1145,POINT (-87.628309 41.883136),60602-20210210
60602,02/11/2021,19,429,8,322,0.281,11,107,0.093,1145,POINT (-87.628309 41.883136),60602-20210211
60602,02/12/2021,38,467,17,339,0.296,21,128,0.112,1145,POINT (-87.628309 41.883136),60602-20210212
60602,02/13/2021,18,485,5,344,0.3,13,141,0.123,1145,POINT (-87.628309 41.883136),60602-20210213
60602,02/14/2021,2,487,1,345,0.301,1,142,0.124,1145,POINT (-87.628309 41.883136),60602-20210214
60602,02/15/2021,7,494,6,351,0.307,1,143,0.125,1145,POINT (-87.628309 41.883136),60602-20210215
60601,02/23/2021,101,3454,69,2245,0.149,32,1209,0.08,15083,POINT (-87.622844 41.886262),60601-20210223
60613,02/03/2021,211,6715,148,5008,0.099,63,1707,0.034,50761,POINT (-87.661343 41.953742),60613-20210203
60613,02/04/2021,313,7028,235,5243,0.103,78,1785,0.035,50761,POINT (-87.661343 41.953742),60613-20210204
60613,02/05/2021,350,7378,262,5505,0.108,88,1873,0.037,50761,POINT (-87.661343 41.953742),60613-20210205
60604,02/24/2021,18,414,4,274,0.333,14,140,0.17,823,POINT (-87.629029 41.878153),60604-20210224
60604,02/25/2021,23,437,5,279,0.339,18,158,0.192,823,POINT (-87.629029 41.878153),60604-20210225
60604,02/26/2021,22,459,8,287,0.349,14,172,0.209,823,POINT (-87.629029 41.878153),60604-20210226
60604,02/27/2021,2,461,1,288,0.35,1,173,0.21,823,POINT (-87.629029 41.878153),60604-20210227
60604,02/28/2021,1,462,1,289,0.351,0,173,0.21,823,POINT (-87.629029 41.878153),60604-20210228
60604,03/01/2021,10,472,4,293,0.356,6,179,0.217,823,POINT (-87.629029 41.878153),60604-20210301
60604,03/02/2021,9,481,1,294,0.357,8,187,0.227,823,POINT (-87.629029 41.878153),60604-20210302
60604,03/03/2021,10,491,3,297,0.361,7,194,0.236,823,POINT (-87.629029 41.878153),60604-20210303
60605,02/01/2021,113,5492,78,3659,0.126,35,1833,0.063,29060,POINT (-87.623449 41.867824),60605-20210201
60605,02/02/2021,177,5669,103,3762,0.129,74,1907,0.066,29060,POINT (-87.623449 41.867824),60605-20210202
60605,02/03/2021,146,5815,104,3866,0.133,42,1949,0.067,29060,POINT (-87.623449 41.867824),60605-20210203
60606,02/26/2021,34,1006,10,620,0.189,24,386,0.117,3287,POINT (-87.63676 41.882634),60606-20210226
60606,02/27/2021,12,1018,8,628,0.191,4,390,0.119,3287,POINT (-87.63676 41.882634),60606-20210227
60606,02/28/2021,4,1022,2,630,0.192,2,392,0.119,3287,POINT (-87.63676 41.882634),60606-20210228
60606,03/01/2021,23,1045,15,645,0.196,8,400,0.122,3287,POINT (-87.63676 41.882634),60606-20210301
60607,02/03/2021,249,5940,170,4008,0.137,79,1932,0.066,29293,POINT (-87.652727 41.876104),60607-20210203
60607,02/04/2021,211,6151,147,4155,0.142,64,1996,0.068,29293,POINT (-87.652727 41.876104),60607-20210204
60607,02/05/2021,203,6354,133,4288,0.146,70,2066,0.071,29293,POINT (-87.652727 41.876104),60607-20210205
60607,02/06/2021,113,6467,75,4363,0.149,38,2104,0.072,29293,POINT (-87.652727 41.876104),60607-20210206
60607,02/14/2021,26,7542,19,4892,0.167,7,2650,0.09,29293,POINT (-87.652727 41.876104),60607-20210214
60607,02/07/2021,16,6483,7,4370,0.149,9,2113,0.072,29293,POINT (-87.652727 41.876104),60607-20210207
60607,02/08/2021,108,6591,69,4439,0.152,39,2152,0.073,29293,POINT (-87.652727 41.876104),60607-20210208
60607,02/09/2021,135,6726,77,4516,0.154,58,2210,0.075,29293,POINT (-87.652727 41.876104),60607-20210209
60607,02/10/2021,223,6949,117,4633,0.158,106,2316,0.079,29293,POINT (-87.652727 41.876104),60607-20210210
60607,02/11/2021,245,7194,97,4730,0.161,148,2464,0.084,29293,POINT (-87.652727 41.876104),60607-20210211
60607,02/12/2021,240,7434,99,4829,0.165,141,2605,0.089,29293,POINT (-87.652727 41.876104),60607-20210212
60607,02/13/2021,82,7516,44,4873,0.166,38,2643,0.09,29293,POINT (-87.652727 41.876104),60607-20210213
60614,02/03/2021,300,9610,224,7161,0.1,76,2449,0.034,71954,POINT (-87.652064 41.922605),60614-20210203
60608,02/02/2021,335,6107,264,4871,0.061,71,1236,0.015,80059,POINT (-87.670366 41.849879),60608-20210202
60608,02/03/2021,446,6553,375,5246,0.066,71,1307,0.016,80059,POINT (-87.670366 41.849879),60608-20210203
60614,02/04/2021,412,10022,362,7523,0.105,50,2499,0.035,71954,POINT (-87.652064 41.922605),60614-20210204
60614,02/05/2021,461,10483,382,7905,0.11,79,2578,0.036,71954,POINT (-87.652064 41.922605),60614-20210205
60614,02/06/2021,225,10708,156,8061,0.112,69,2647,0.037,71954,POINT (-87.652064 41.922605),60614-20210206
60614,02/07/2021,113,10821,79,8140,0.113,34,2681,0.037,71954,POINT (-87.652064 41.922605),60614-20210207
60614,02/08/2021,313,11134,174,8314,0.116,139,2820,0.039,71954,POINT (-87.652064 41.922605),60614-20210208
60614,02/09/2021,285,11419,169,8483,0.118,116,2936,0.041,71954,POINT (-87.652064 41.922605),60614-20210209
60614,02/10/2021,524,11943,371,8854,0.123,153,3089,0.043,71954,POINT (-87.652064 41.922605),60614-20210210
60614,02/11/2021,461,12404,212,9066,0.126,249,3338,0.046,71954,POINT (-87.652064 41.922605),60614-20210211
60614,02/12/2021,737,13141,304,9370,0.13,433,3771,0.052,71954,POINT (-87.652064 41.922605),60614-20210212
60614,02/13/2021,263,13404,154,9524,0.132,109,3880,0.054,71954,POINT (-87.652064 41.922605),60614-20210213
60614,02/14/2021,103,13507,74,9598,0.133,29,3909,0.054,71954,POINT (-87.652064 41.922605),60614-20210214
60614,02/15/2021,317,13824,116,9714,0.135,201,4110,0.057,71954,POINT (-87.652064 41.922605),60614-20210215
60614,02/16/2021,373,14197,228,9942,0.138,145,4255,0.059,71954,POINT (-87.652064 41.922605),60614-20210216
60614,02/17/2021,391,14588,155,10097,0.14,236,4491,0.062,71954,POINT (-87.652064 41.922605),60614-20210217
60609,02/01/2021,113,2633,97,2189,0.036,16,444,0.007,60939,POINT (-87.653382 41.812017),60609-20210201
60609,02/02/2021,152,2785,117,2306,0.038,35,479,0.008,60939,POINT (-87.653382 41.812017),60609-20210202
60609,02/03/2021,282,3067,169,2475,0.041,113,592,0.01,60939,POINT (-87.653382 41.812017),60609-20210203
60609,02/04/2021,242,3309,207,2682,0.044,35,627,0.01,60939,POINT (-87.653382 41.812017),60609-20210204
60615,02/25/2021,222,10701,78,6392,0.157,144,4309,0.106,40590,POINT (-87.602725 41.801993),60615-20210225
60615,02/26/2021,221,10922,94,6486,0.16,127,4436,0.109,40590,POINT (-87.602725 41.801993),60615-20210226
60610,02/01/2021,138,4960,106,3784,0.093,32,1176,0.029,40548,POINT (-87.63581 41.90455),60610-20210201
60610,02/02/2021,229,5189,154,3938,0.097,75,1251,0.031,40548,POINT (-87.63581 41.90455),60610-20210202
60610,02/03/2021,154,5343,115,4053,0.1,39,1290,0.032,40548,POINT (-87.63581 41.90455),60610-20210203
60610,02/04/2021,308,5651,261,4314,0.106,47,1337,0.033,40548,POINT (-87.63581 41.90455),60610-20210204
60610,02/05/2021,511,6162,406,4720,0.116,105,1442,0.036,40548,POINT (-87.63581 41.90455),60610-20210205
60610,02/06/2021,118,6280,82,4802,0.118,36,1478,0.036,40548,POINT (-87.63581 41.90455),60610-20210206
60610,02/07/2021,37,6317,29,4831,0.119,8,1486,0.037,40548,POINT (-87.63581 41.90455),60610-20210207
60610,02/08/2021,152,6469,96,4927,0.122,56,1542,0.038,40548,POINT (-87.63581 41.90455),60610-20210208
60610,02/09/2021,175,6644,132,5059,0.125,43,1585,0.039,40548,POINT (-87.63581 41.90455),60610-20210209
60610,02/10/2021,310,6954,236,5295,0.131,74,1659,0.041,40548,POINT (-87.63581 41.90455),60610-20210210
60610,02/11/2021,349,7303,110,5405,0.133,239,1898,0.047,40548,POINT (-87.63581 41.90455),60610-20210211
60610,02/12/2021,384,7687,111,5516,0.136,273,2171,0.054,40548,POINT (-87.63581 41.90455),60610-20210212
60610,02/13/2021,164,7851,92,5608,0.138,72,2243,0.055,40548,POINT (-87.63581 41.90455),60610-20210213
60610,02/14/2021,46,7897,36,5644,0.139,10,2253,0.056,40548,POINT (-87.63581 41.90455),60610-20210214
60610,02/15/2021,100,7997,57,5701,0.141,43,2296,0.057,40548,POINT (-87.63581 41.90455),60610-20210215
60610,02/16/2021,241,8238,197,5898,0.145,44,2340,0.058,40548,POINT (-87.63581 41.90455),60610-20210216
60610,02/17/2021,252,8490,90,5988,0.148,162,2502,0.062,40548,POINT (-87.63581 41.90455),60610-20210217
60610,02/18/2021,344,8834,132,6120,0.151,212,2714,0.067,40548,POINT (-87.63581 41.90455),60610-20210218
60610,02/19/2021,348,9182,77,6197,0.153,271,2985,0.074,40548,POINT (-87.63581 41.90455),60610-20210219
60615,02/28/2021,140,11216,36,6624,0.163,104,4592,0.113,40590,POINT (-87.602725 41.801993),60615-20210228
60615,03/01/2021,200,11416,135,6759,0.167,65,4657,0.115,40590,POINT (-87.602725 41.801993),60615-20210301
60615,03/02/2021,157,11573,90,6849,0.169,67,4724,0.116,40590,POINT (-87.602725 41.801993),60615-20210302
60615,03/03/2021,225,11798,119,6968,0.172,106,4830,0.119,40590,POINT (-87.602725 41.801993),60615-20210303
60615,03/04/2021,220,12018,137,7105,0.175,83,4913,0.121,40590,POINT (-87.602725 41.801993),60615-20210304
60615,03/05/2021,239,12257,148,7253,0.179,91,5004,0.123,40590,POINT (-87.602725 41.801993),60615-20210305
60616,02/17/2021,432,9013,274,6609,0.122,158,2404,0.044,54197,POINT (-87.629531 41.844869),60616-20210217
60610,02/20/2021,100,9282,23,6220,0.153,77,3062,0.076,40548,POINT (-87.63581 41.90455),60610-20210220
60610,02/21/2021,52,9334,17,6237,0.154,35,3097,0.076,40548,POINT (-87.63581 41.90455),60610-20210221
60610,02/22/2021,165,9499,48,6285,0.155,117,3214,0.079,40548,POINT (-87.63581 41.90455),60610-20210222
60610,02/23/2021,315,9814,179,6464,0.159,136,3350,0.083,40548,POINT (-87.63581 41.90455),60610-20210223
60616,02/16/2021,147,8581,103,6335,0.117,44,2246,0.041,54197,POINT (-87.629531 41.844869),60616-20210216
60617,02/06/2021,202,5117,170,4360,0.052,32,757,0.009,83553,POINT (-87.556897 41.721257),60617-20210206
60617,02/07/2021,50,5167,49,4409,0.053,1,758,0.009,83553,POINT (-87.556897 41.721257),60617-20210207
60617,02/08/2021,253,5420,189,4598,0.055,64,822,0.01,83553,POINT (-87.556897 41.721257),60617-20210208
60617,02/09/2021,231,5651,162,4760,0.057,69,891,0.011,83553,POINT (-87.556897 41.721257),60617-20210209
60617,02/10/2021,372,6023,260,5020,0.06,112,1003,0.012,83553,POINT (-87.556897 41.721257),60617-20210210
60617,02/11/2021,528,6551,308,5328,0.064,220,1223,0.015,83553,POINT (-87.556897 41.721257),60617-20210211
60617,02/12/2021,460,7011,255,5583,0.067,205,1428,0.017,83553,POINT (-87.556897 41.721257),60617-20210212
60617,02/13/2021,287,7298,193,5776,0.069,94,1522,0.018,83553,POINT (-87.556897 41.721257),60617-20210213
60617,02/14/2021,78,7376,75,5851,0.07,3,1525,0.018,83553,POINT (-87.556897 41.721257),60617-20210214
60617,02/15/2021,211,7587,138,5989,0.072,73,1598,0.019,83553,POINT (-87.556897 41.721257),60617-20210215
60617,02/16/2021,128,7715,54,6043,0.072,74,1672,0.02,83553,POINT (-87.556897 41.721257),60617-20210216
60617,02/17/2021,414,8129,187,6230,0.075,227,1899,0.023,83553,POINT (-87.556897 41.721257),60617-20210217
60617,02/18/2021,443,8572,212,6442,0.077,231,2130,0.025,83553,POINT (-87.556897 41.721257),60617-20210218
60617,02/19/2021,403,8975,151,6593,0.079,252,2382,0.029,83553,POINT (-87.556897 41.721257),60617-20210219
60617,02/20/2021,197,9172,87,6680,0.08,110,2492,0.03,83553,POINT (-87.556897 41.721257),60617-20210220
60617,02/21/2021,74,9246,45,6725,0.08,29,2521,0.03,83553,POINT (-87.556897 41.721257),60617-20210221
60617,02/22/2021,285,9531,160,6885,0.082,125,2646,0.032,83553,POINT (-87.556897 41.721257),60617-20210222
60617,02/23/2021,341,9872,185,7070,0.085,156,2802,0.034,83553,POINT (-87.556897 41.721257),60617-20210223
60617,02/24/2021,320,10192,195,7265,0.087,125,2927,0.035,83553,POINT (-87.556897 41.721257),60617-20210224
60617,02/25/2021,523,10715,284,7549,0.09,239,3166,0.038,83553,POINT (-87.556897 41.721257),60617-20210225
60617,02/26/2021,461,11176,220,7769,0.093,241,3407,0.041,83553,POINT (-87.556897 41.721257),60617-20210226
60618,02/09/2021,380,10737,279,8189,0.086,101,2548,0.027,94907,POINT (-87.703343 41.946699),60618-20210209
60618,02/10/2021,604,11341,448,8637,0.091,156,2704,0.028,94907,POINT (-87.703343 41.946699),60618-20210210
60618,02/11/2021,573,11914,339,8976,0.095,234,2938,0.031,94907,POINT (-87.703343 41.946699),60618-20210211
60618,02/12/2021,544,12458,387,9363,0.099,157,3095,0.033,94907,POINT (-87.703343 41.946699),60618-20210212
60618,02/13/2021,401,12859,305,9668,0.102,96,3191,0.034,94907,POINT (-87.703343 41.946699),60618-20210213
60619,02/12/2021,305,5682,151,4472,0.073,154,1210,0.02,61207,POINT (-87.60569 41.744737),60619-20210212
60619,02/13/2021,236,5918,165,4637,0.076,71,1281,0.021,61207,POINT (-87.60569 41.744737),60619-20210213
60619,02/14/2021,46,5964,44,4681,0.076,2,1283,0.021,61207,POINT (-87.60569 41.744737),60619-20210214
60619,02/15/2021,179,6143,100,4781,0.078,79,1362,0.022,61207,POINT (-87.60569 41.744737),60619-20210215
60619,02/16/2021,112,6255,42,4823,0.079,70,1432,0.023,61207,POINT (-87.60569 41.744737),60619-20210216
60619,02/17/2021,226,6481,77,4900,0.08,149,1581,0.026,61207,POINT (-87.60569 41.744737),60619-20210217
60619,02/18/2021,286,6767,112,5012,0.082,174,1755,0.029,61207,POINT (-87.60569 41.744737),60619-20210218
60619,02/19/2021,426,7193,161,5173,0.085,265,2020,0.033,61207,POINT (-87.60569 41.744737),60619-20210219
60619,02/20/2021,129,7322,41,5214,0.085,88,2108,0.034,61207,POINT (-87.60569 41.744737),60619-20210220
60619,02/21/2021,44,7366,22,5236,0.086,22,2130,0.035,61207,POINT (-87.60569 41.744737),60619-20210221
60619,02/22/2021,209,7575,106,5342,0.087,103,2233,0.036,61207,POINT (-87.60569 41.744737),60619-20210222
60619,02/23/2021,222,7797,117,5459,0.089,105,2338,0.038,61207,POINT (-87.60569 41.744737),60619-20210223
60619,02/24/2021,293,8090,134,5593,0.091,159,2497,0.041,61207,POINT (-87.60569 41.744737),60619-20210224
60619,02/25/2021,348,8438,159,5752,0.094,189,2686,0.044,61207,POINT (-87.60569 41.744737),60619-20210225
60619,02/26/2021,398,8836,217,5969,0.098,181,2867,0.047,61207,POINT (-87.60569 41.744737),60619-20210226
60619,02/27/2021,249,9085,177,6146,0.1,72,2939,0.048,61207,POINT (-87.60569 41.744737),60619-20210227
60619,02/28/2021,92,9177,56,6202,0.101,36,2975,0.049,61207,POINT (-87.60569 41.744737),60619-20210228
60619,03/01/2021,321,9498,173,6375,0.104,148,3123,0.051,61207,POINT (-87.60569 41.744737),60619-20210301
60619,03/02/2021,264,9762,124,6499,0.106,140,3263,0.053,61207,POINT (-87.60569 41.744737),60619-20210302
60620,02/02/2021,155,2578,127,2167,0.032,28,411,0.006,67711,POINT (-87.651656 41.740873),60620-20210202
60621,02/16/2021,22,1787,12,1411,0.05,10,376,0.013,28018,POINT (-87.638812 41.776931),60621-20210216
60621,02/17/2021,50,1837,26,1437,0.051,24,400,0.014,28018,POINT (-87.638812 41.776931),60621-20210217
60621,02/18/2021,75,1912,41,1478,0.053,34,434,0.015,28018,POINT (-87.638812 41.776931),60621-20210218
60621,02/19/2021,170,2082,121,1599,0.057,49,483,0.017,28018,POINT (-87.638812 41.776931),60621-20210219
60622,01/27/2021,232,6662,159,4713,0.088,73,1949,0.037,53294,POINT (-87.681818 41.902762),60622-20210127
60622,01/28/2021,302,6964,228,4941,0.093,74,2023,0.038,53294,POINT (-87.681818 41.902762),60622-20210128
60622,01/29/2021,250,7214,182,5123,0.096,68,2091,0.039,53294,POINT (-87.681818 41.902762),60622-20210129
60622,01/30/2021,133,7347,95,5218,0.098,38,2129,0.04,53294,POINT (-87.681818 41.902762),60622-20210130
60622,01/31/2021,45,7392,35,5253,0.099,10,2139,0.04,53294,POINT (-87.681818 41.902762),60622-20210131
60622,02/01/2021,161,7553,126,5379,0.101,35,2174,0.041,53294,POINT (-87.681818 41.902762),60622-20210201
60622,02/02/2021,284,7837,182,5561,0.104,102,2276,0.043,53294,POINT (-87.681818 41.902762),60622-20210202
60622,02/03/2021,280,8117,176,5737,0.108,104,2380,0.045,53294,POINT (-87.681818 41.902762),60622-20210203
60622,02/04/2021,282,8399,228,5965,0.112,54,2434,0.046,53294,POINT (-87.681818 41.902762),60622-20210204
60622,02/05/2021,299,8698,215,6180,0.116,84,2518,0.047,53294,POINT (-87.681818 41.902762),60622-20210205
60622,02/06/2021,205,8903,132,6312,0.118,73,2591,0.049,53294,POINT (-87.681818 41.902762),60622-20210206
60622,02/07/2021,60,8963,43,6355,0.119,17,2608,0.049,53294,POINT (-87.681818 41.902762),60622-20210207
60615,02/09/2021,223,7554,103,5261,0.13,120,2293,0.056,40590,POINT (-87.602725 41.801993),60615-20210209
60615,02/10/2021,275,7829,134,5395,0.133,141,2434,0.06,40590,POINT (-87.602725 41.801993),60615-20210210
60615,02/03/2021,154,6351,120,4608,0.114,34,1743,0.043,40590,POINT (-87.602725 41.801993),60615-20210203
60615,02/04/2021,257,6608,165,4773,0.118,92,1835,0.045,40590,POINT (-87.602725 41.801993),60615-20210204
60615,02/05/2021,232,6840,119,4892,0.121,113,1948,0.048,40590,POINT (-87.602725 41.801993),60615-20210205
60615,02/06/2021,149,6989,67,4959,0.122,82,2030,0.05,40590,POINT (-87.602725 41.801993),60615-20210206
60615,02/07/2021,112,7101,112,5071,0.125,0,2030,0.05,40590,POINT (-87.602725 41.801993),60615-20210207
60615,02/08/2021,230,7331,87,5158,0.127,143,2173,0.054,40590,POINT (-87.602725 41.801993),60615-20210208
60615,02/11/2021,434,8263,121,5516,0.136,313,2747,0.068,40590,POINT (-87.602725 41.801993),60615-20210211
60615,02/12/2021,364,8627,112,5628,0.139,252,2999,0.074,40590,POINT (-87.602725 41.801993),60615-20210212
60615,02/13/2021,189,8816,82,5710,0.141,107,3106,0.077,40590,POINT (-87.602725 41.801993),60615-20210213
60615,02/14/2021,20,8836,16,5726,0.141,4,3110,0.077,40590,POINT (-87.602725 41.801993),60615-20210214
60615,02/15/2021,131,8967,55,5781,0.142,76,3186,0.078,40590,POINT (-87.602725 41.801993),60615-20210215
60615,02/16/2021,121,9088,55,5836,0.144,66,3252,0.08,40590,POINT (-87.602725 41.801993),60615-20210216
60615,02/17/2021,179,9267,58,5894,0.145,121,3373,0.083,40590,POINT (-87.602725 41.801993),60615-20210217
60615,02/18/2021,262,9529,104,5998,0.148,158,3531,0.087,40590,POINT (-87.602725 41.801993),60615-20210218
60615,02/19/2021,239,9768,57,6055,0.149,182,3713,0.091,40590,POINT (-87.602725 41.801993),60615-20210219
60615,02/20/2021,79,9847,20,6075,0.15,59,3772,0.093,40590,POINT (-87.602725 41.801993),60615-20210220
60615,02/21/2021,108,9955,13,6088,0.15,95,3867,0.095,40590,POINT (-87.602725 41.801993),60615-20210221
60615,02/22/2021,147,10102,55,6143,0.151,92,3959,0.098,40590,POINT (-87.602725 41.801993),60615-20210222
60615,02/23/2021,182,10284,92,6235,0.154,90,4049,0.1,40590,POINT (-87.602725 41.801993),60615-20210223
60615,02/24/2021,195,10479,79,6314,0.156,116,4165,0.103,40590,POINT (-87.602725 41.801993),60615-20210224
60622,02/08/2021,194,9157,124,6479,0.122,70,2678,0.05,53294,POINT (-87.681818 41.902762),60622-20210208
60622,02/09/2021,264,9421,170,6649,0.125,94,2772,0.052,53294,POINT (-87.681818 41.902762),60622-20210209
60622,02/10/2021,313,9734,194,6843,0.128,119,2891,0.054,53294,POINT (-87.681818 41.902762),60622-20210210
60622,02/11/2021,516,10250,236,7079,0.133,280,3171,0.06,53294,POINT (-87.681818 41.902762),60622-20210211
60622,02/12/2021,422,10672,227,7306,0.137,195,3366,0.063,53294,POINT (-87.681818 41.902762),60622-20210212
60622,02/13/2021,245,10917,188,7494,0.141,57,3423,0.064,53294,POINT (-87.681818 41.902762),60622-20210213
60622,02/14/2021,47,10964,35,7529,0.141,12,3435,0.064,53294,POINT (-87.681818 41.902762),60622-20210214
60622,02/15/2021,155,11119,96,7625,0.143,59,3494,0.066,53294,POINT (-87.681818 41.902762),60622-20210215
60622,02/16/2021,115,11234,68,7693,0.144,47,3541,0.066,53294,POINT (-87.681818 41.902762),60622-20210216
60622,02/17/2021,267,11501,140,7833,0.147,127,3668,0.069,53294,POINT (-87.681818 41.902762),60622-20210217
60622,02/18/2021,310,11811,166,7999,0.15,144,3812,0.072,53294,POINT (-87.681818 41.902762),60622-20210218
60622,02/19/2021,284,12095,131,8130,0.153,153,3965,0.074,53294,POINT (-87.681818 41.902762),60622-20210219
60622,02/20/2021,143,12238,55,8185,0.154,88,4053,0.076,53294,POINT (-87.681818 41.902762),60622-20210220
60622,02/21/2021,69,12307,31,8216,0.154,38,4091,0.077,53294,POINT (-87.681818 41.902762),60622-20210221
60622,02/22/2021,175,12482,51,8267,0.155,124,4215,0.079,53294,POINT (-87.681818 41.902762),60622-20210222
60622,02/23/2021,276,12758,111,8378,0.157,165,4380,0.082,53294,POINT (-87.681818 41.902762),60622-20210223
60622,02/24/2021,286,13044,115,8493,0.159,171,4551,0.085,53294,POINT (-87.681818 41.902762),60622-20210224
60622,02/25/2021,322,13366,136,8629,0.162,186,4737,0.089,53294,POINT (-87.681818 41.902762),60622-20210225
60622,02/26/2021,365,13731,176,8805,0.165,189,4926,0.092,53294,POINT (-87.681818 41.902762),60622-20210226
60617,02/03/2021,271,4221,234,3633,0.043,37,588,0.007,83553,POINT (-87.556897 41.721257),60617-20210203
60617,02/04/2021,331,4552,289,3922,0.047,42,630,0.008,83553,POINT (-87.556897 41.721257),60617-20210204
60622,02/27/2021,244,13975,152,8957,0.168,92,5018,0.094,53294,POINT (-87.681818 41.902762),60622-20210227
60622,02/28/2021,114,14089,55,9012,0.169,59,5077,0.095,53294,POINT (-87.681818 41.902762),60622-20210228
60622,03/01/2021,219,14308,108,9120,0.171,111,5188,0.097,53294,POINT (-87.681818 41.902762),60622-20210301
60623,02/06/2021,174,4687,155,3939,0.048,19,748,0.009,81283,POINT (-87.717446 41.850321),60623-20210206
60623,02/07/2021,23,4710,18,3957,0.049,5,753,0.009,81283,POINT (-87.717446 41.850321),60623-20210207
60623,02/08/2021,238,4948,220,4177,0.051,18,771,0.009,81283,POINT (-87.717446 41.850321),60623-20210208
60623,02/09/2021,332,5280,262,4439,0.055,70,841,0.01,81283,POINT (-87.717446 41.850321),60623-20210209
60623,02/10/2021,353,5633,297,4736,0.058,56,897,0.011,81283,POINT (-87.717446 41.850321),60623-20210210
60623,02/11/2021,395,6028,295,5031,0.062,100,997,0.012,81283,POINT (-87.717446 41.850321),60623-20210211
60623,02/12/2021,348,6376,260,5291,0.065,88,1085,0.013,81283,POINT (-87.717446 41.850321),60623-20210212
60623,02/13/2021,239,6615,181,5472,0.067,58,1143,0.014,81283,POINT (-87.717446 41.850321),60623-20210213
60623,02/14/2021,24,6639,16,5488,0.068,8,1151,0.014,81283,POINT (-87.717446 41.850321),60623-20210214
60623,02/15/2021,197,6836,164,5652,0.07,33,1184,0.015,81283,POINT (-87.717446 41.850321),60623-20210215
60623,02/16/2021,159,6995,138,5790,0.071,21,1205,0.015,81283,POINT (-87.717446 41.850321),60623-20210216
60623,02/17/2021,312,7307,220,6010,0.074,92,1297,0.016,81283,POINT (-87.717446 41.850321),60623-20210217
60623,02/18/2021,305,7612,211,6221,0.077,94,1391,0.017,81283,POINT (-87.717446 41.850321),60623-20210218
60623,02/19/2021,251,7863,147,6368,0.078,104,1495,0.018,81283,POINT (-87.717446 41.850321),60623-20210219
60623,02/20/2021,164,8027,94,6462,0.08,70,1565,0.019,81283,POINT (-87.717446 41.850321),60623-20210220
60623,02/21/2021,26,8053,16,6478,0.08,10,1575,0.019,81283,POINT (-87.717446 41.850321),60623-20210221
60623,02/22/2021,358,8411,233,6711,0.083,125,1700,0.021,81283,POINT (-87.717446 41.850321),60623-20210222
60623,02/23/2021,464,8875,272,6983,0.086,192,1892,0.023,81283,POINT (-87.717446 41.850321),60623-20210223
60623,02/24/2021,874,9749,689,7672,0.094,185,2077,0.026,81283,POINT (-87.717446 41.850321),60623-20210224
60623,02/25/2021,920,10669,695,8367,0.103,225,2302,0.028,81283,POINT (-87.717446 41.850321),60623-20210225
60623,02/26/2021,955,11624,713,9080,0.112,242,2544,0.031,81283,POINT (-87.717446 41.850321),60623-20210226
60623,02/27/2021,603,12227,539,9619,0.118,64,2608,0.032,81283,POINT (-87.717446 41.850321),60623-20210227
60623,02/28/2021,760,12987,736,10355,0.127,24,2632,0.032,81283,POINT (-87.717446 41.850321),60623-20210228
60623,03/01/2021,503,13490,331,10686,0.131,172,2804,0.034,81283,POINT (-87.717446 41.850321),60623-20210301
60623,03/02/2021,552,14042,342,11028,0.136,210,3014,0.037,81283,POINT (-87.717446 41.850321),60623-20210302
60623,03/03/2021,727,14769,426,11454,0.141,301,3315,0.041,81283,POINT (-87.717446 41.850321),60623-20210303
60623,03/04/2021,670,15439,475,11929,0.147,195,3510,0.043,81283,POINT (-87.717446 41.850321),60623-20210304
60624,02/09/2021,92,1801,70,1515,0.043,22,286,0.008,34892,POINT (-87.722735 41.879417),60624-20210209
60624,02/10/2021,95,1896,80,1595,0.046,15,301,0.009,34892,POINT (-87.722735 41.879417),60624-20210210
60624,02/11/2021,189,2085,121,1716,0.049,68,369,0.011,34892,POINT (-87.722735 41.879417),60624-20210211
60624,02/12/2021,144,2229,111,1827,0.052,33,402,0.012,34892,POINT (-87.722735 41.879417),60624-20210212
60624,02/13/2021,57,2286,38,1865,0.053,19,421,0.012,34892,POINT (-87.722735 41.879417),60624-20210213
60624,02/14/2021,8,2294,6,1871,0.054,2,423,0.012,34892,POINT (-87.722735 41.879417),60624-20210214
60624,02/15/2021,48,2342,46,1917,0.055,2,425,0.012,34892,POINT (-87.722735 41.879417),60624-20210215
60624,02/16/2021,38,2380,29,1946,0.056,9,434,0.012,34892,POINT (-87.722735 41.879417),60624-20210216
60624,02/17/2021,101,2481,54,2000,0.057,47,481,0.014,34892,POINT (-87.722735 41.879417),60624-20210217
60624,02/18/2021,106,2587,65,2065,0.059,41,522,0.015,34892,POINT (-87.722735 41.879417),60624-20210218
60624,02/19/2021,113,2700,67,2132,0.061,46,568,0.016,34892,POINT (-87.722735 41.879417),60624-20210219
60624,02/20/2021,37,2737,20,2152,0.062,17,585,0.017,34892,POINT (-87.722735 41.879417),60624-20210220
60624,02/21/2021,5,2742,3,2155,0.062,2,587,0.017,34892,POINT (-87.722735 41.879417),60624-20210221
60624,02/22/2021,87,2829,40,2195,0.063,47,634,0.018,34892,POINT (-87.722735 41.879417),60624-20210222
60624,02/23/2021,130,2959,84,2279,0.065,46,680,0.019,34892,POINT (-87.722735 41.879417),60624-20210223
60624,02/24/2021,179,3138,117,2396,0.069,62,742,0.021,34892,POINT (-87.722735 41.879417),60624-20210224
60624,02/25/2021,156,3294,79,2475,0.071,77,819,0.023,34892,POINT (-87.722735 41.879417),60624-20210225
60624,02/26/2021,163,3457,85,2560,0.073,78,897,0.026,34892,POINT (-87.722735 41.879417),60624-20210226
60624,02/27/2021,65,3522,39,2599,0.074,26,923,0.026,34892,POINT (-87.722735 41.879417),60624-20210227
60624,02/28/2021,20,3542,7,2606,0.075,13,936,0.027,34892,POINT (-87.722735 41.879417),60624-20210228
60624,03/01/2021,146,3688,72,2678,0.077,74,1010,0.029,34892,POINT (-87.722735 41.879417),60624-20210301
60624,03/02/2021,135,3823,76,2754,0.079,59,1069,0.031,34892,POINT (-87.722735 41.879417),60624-20210302
60624,03/03/2021,178,4001,105,2859,0.082,73,1142,0.033,34892,POINT (-87.722735 41.879417),60624-20210303
60624,03/04/2021,200,4201,133,2992,0.086,67,1209,0.035,34892,POINT (-87.722735 41.879417),60624-20210304
60619,02/01/2021,153,3065,128,2689,0.044,25,376,0.006,61207,POINT (-87.60569 41.744737),60619-20210201
60619,02/02/2021,156,3221,120,2809,0.046,36,412,0.007,61207,POINT (-87.60569 41.744737),60619-20210202
60619,02/03/2021,228,3449,191,3000,0.049,37,449,0.007,61207,POINT (-87.60569 41.744737),60619-20210203
60619,02/04/2021,242,3691,195,3195,0.052,47,496,0.008,61207,POINT (-87.60569 41.744737),60619-20210204
60619,02/05/2021,248,3939,205,3400,0.056,43,539,0.009,61207,POINT (-87.60569 41.744737),60619-20210205
60619,02/06/2021,133,4072,101,3501,0.057,32,571,0.009,61207,POINT (-87.60569 41.744737),60619-20210206
60619,02/07/2021,61,4133,56,3557,0.058,5,576,0.009,61207,POINT (-87.60569 41.744737),60619-20210207
60619,02/08/2021,211,4344,166,3723,0.061,45,621,0.01,61207,POINT (-87.60569 41.744737),60619-20210208
60625,02/19/2021,368,12657,176,9222,0.116,192,3435,0.043,79444,POINT (-87.701816 41.971155),60625-20210219
60625,02/20/2021,183,12840,72,9294,0.117,111,3546,0.045,79444,POINT (-87.701816 41.971155),60625-20210220
60625,02/21/2021,109,12949,49,9343,0.118,60,3606,0.045,79444,POINT (-87.701816 41.971155),60625-20210221
60619,02/09/2021,239,4583,152,3875,0.063,87,708,0.012,61207,POINT (-87.60569 41.744737),60619-20210209
60619,02/10/2021,341,4924,235,4110,0.067,106,814,0.013,61207,POINT (-87.60569 41.744737),60619-20210210
60619,02/11/2021,453,5377,211,4321,0.071,242,1056,0.017,61207,POINT (-87.60569 41.744737),60619-20210211
60624,03/05/2021,179,4380,116,3108,0.089,63,1272,0.036,34892,POINT (-87.722735 41.879417),60624-20210305
60625,02/04/2021,383,7614,302,5883,0.074,81,1731,0.022,79444,POINT (-87.701816 41.971155),60625-20210204
60625,02/05/2021,401,8015,279,6162,0.078,122,1853,0.023,79444,POINT (-87.701816 41.971155),60625-20210205
60625,02/06/2021,275,8290,212,6374,0.08,63,1916,0.024,79444,POINT (-87.701816 41.971155),60625-20210206
60625,02/07/2021,76,8366,63,6437,0.081,13,1929,0.024,79444,POINT (-87.701816 41.971155),60625-20210207
60625,02/08/2021,242,8608,198,6635,0.084,44,1973,0.025,79444,POINT (-87.701816 41.971155),60625-20210208
60625,02/09/2021,328,8936,242,6877,0.087,86,2059,0.026,79444,POINT (-87.701816 41.971155),60625-20210209
60625,02/10/2021,503,9439,347,7224,0.091,156,2215,0.028,79444,POINT (-87.701816 41.971155),60625-20210210
60625,02/11/2021,498,9937,326,7550,0.095,172,2387,0.03,79444,POINT (-87.701816 41.971155),60625-20210211
60625,02/12/2021,472,10409,321,7871,0.099,151,2538,0.032,79444,POINT (-87.701816 41.971155),60625-20210212
60625,02/13/2021,343,10752,249,8120,0.102,94,2632,0.033,79444,POINT (-87.701816 41.971155),60625-20210213
60625,02/14/2021,114,10866,80,8200,0.103,34,2666,0.034,79444,POINT (-87.701816 41.971155),60625-20210214
60625,02/15/2021,311,11177,247,8447,0.106,64,2730,0.034,79444,POINT (-87.701816 41.971155),60625-20210215
60625,02/16/2021,193,11370,143,8590,0.108,50,2780,0.035,79444,POINT (-87.701816 41.971155),60625-20210216
60625,02/17/2021,462,11832,239,8829,0.111,223,3003,0.038,79444,POINT (-87.701816 41.971155),60625-20210217
60625,02/18/2021,457,12289,217,9046,0.114,240,3243,0.041,79444,POINT (-87.701816 41.971155),60625-20210218
60620,01/19/2021,68,1007,52,844,0.012,16,163,0.002,67711,POINT (-87.651656 41.740873),60620-20210119
60620,01/20/2021,83,1090,58,902,0.013,25,188,0.003,67711,POINT (-87.651656 41.740873),60620-20210120
60620,01/21/2021,128,1218,108,1010,0.015,20,208,0.003,67711,POINT (-87.651656 41.740873),60620-20210121
60620,01/22/2021,103,1321,94,1104,0.016,9,217,0.003,67711,POINT (-87.651656 41.740873),60620-20210122
60620,01/23/2021,64,1385,59,1163,0.017,5,222,0.003,67711,POINT (-87.651656 41.740873),60620-20210123
60620,01/24/2021,27,1412,27,1190,0.018,0,222,0.003,67711,POINT (-87.651656 41.740873),60620-20210124
60620,01/25/2021,108,1520,87,1277,0.019,21,243,0.004,67711,POINT (-87.651656 41.740873),60620-20210125
60620,01/26/2021,121,1641,88,1365,0.02,33,276,0.004,67711,POINT (-87.651656 41.740873),60620-20210126
60620,01/27/2021,135,1776,111,1476,0.022,24,300,0.004,67711,POINT (-87.651656 41.740873),60620-20210127
60620,01/28/2021,166,1942,144,1620,0.024,22,322,0.005,67711,POINT (-87.651656 41.740873),60620-20210128
60620,01/29/2021,218,2160,186,1806,0.027,32,354,0.005,67711,POINT (-87.651656 41.740873),60620-20210129
60620,01/30/2021,96,2256,82,1888,0.028,14,368,0.005,67711,POINT (-87.651656 41.740873),60620-20210130
60620,01/31/2021,13,2269,13,1901,0.028,0,368,0.005,67711,POINT (-87.651656 41.740873),60620-20210131
60626,01/26/2021,161,3638,106,3091,0.061,55,547,0.011,50544,POINT (-87.669834 42.009469),60626-20210126
60626,01/27/2021,438,4076,177,3268,0.065,261,808,0.016,50544,POINT (-87.669834 42.009469),60626-20210127
60626,01/28/2021,166,4242,136,3404,0.067,30,838,0.017,50544,POINT (-87.669834 42.009469),60626-20210128
60626,01/29/2021,159,4401,147,3551,0.07,12,850,0.017,50544,POINT (-87.669834 42.009469),60626-20210129
60626,01/30/2021,107,4508,95,3646,0.072,12,862,0.017,50544,POINT (-87.669834 42.009469),60626-20210130
60626,01/31/2021,47,4555,32,3678,0.073,15,877,0.017,50544,POINT (-87.669834 42.009469),60626-20210131
60626,02/01/2021,189,4744,143,3821,0.076,46,923,0.018,50544,POINT (-87.669834 42.009469),60626-20210201
60626,02/02/2021,315,5059,167,3988,0.079,148,1071,0.021,50544,POINT (-87.669834 42.009469),60626-20210202
60626,02/03/2021,186,5245,124,4112,0.081,62,1133,0.022,50544,POINT (-87.669834 42.009469),60626-20210203
60626,02/04/2021,258,5503,177,4289,0.085,81,1214,0.024,50544,POINT (-87.669834 42.009469),60626-20210204
60626,02/05/2021,266,5769,168,4457,0.088,98,1312,0.026,50544,POINT (-87.669834 42.009469),60626-20210205
60626,02/06/2021,149,5918,91,4548,0.09,58,1370,0.027,50544,POINT (-87.669834 42.009469),60626-20210206
60626,02/07/2021,44,5962,35,4583,0.091,9,1379,0.027,50544,POINT (-87.669834 42.009469),60626-20210207
60626,02/08/2021,141,6103,115,4698,0.093,26,1405,0.028,50544,POINT (-87.669834 42.009469),60626-20210208
60626,02/09/2021,292,6395,174,4872,0.096,118,1523,0.03,50544,POINT (-87.669834 42.009469),60626-20210209
60626,02/10/2021,278,6673,176,5048,0.1,102,1625,0.032,50544,POINT (-87.669834 42.009469),60626-20210210
60626,02/11/2021,496,7169,185,5233,0.104,311,1936,0.038,50544,POINT (-87.669834 42.009469),60626-20210211
60621,02/01/2021,27,1056,23,876,0.031,4,180,0.006,28018,POINT (-87.638812 41.776931),60621-20210201
60621,02/02/2021,33,1089,23,899,0.032,10,190,0.007,28018,POINT (-87.638812 41.776931),60621-20210202
60621,02/03/2021,57,1146,48,947,0.034,9,199,0.007,28018,POINT (-87.638812 41.776931),60621-20210203
60621,02/04/2021,78,1224,66,1013,0.036,12,211,0.008,28018,POINT (-87.638812 41.776931),60621-20210204
60621,02/05/2021,54,1278,49,1062,0.038,5,216,0.008,28018,POINT (-87.638812 41.776931),60621-20210205
60621,02/06/2021,36,1314,34,1096,0.039,2,218,0.008,28018,POINT (-87.638812 41.776931),60621-20210206
60621,02/07/2021,1,1315,1,1097,0.039,0,218,0.008,28018,POINT (-87.638812 41.776931),60621-20210207
60621,02/08/2021,38,1353,34,1131,0.04,4,222,0.008,28018,POINT (-87.638812 41.776931),60621-20210208
60621,02/09/2021,49,1402,36,1167,0.042,13,235,0.008,28018,POINT (-87.638812 41.776931),60621-20210209
60621,02/10/2021,79,1481,59,1226,0.044,20,255,0.009,28018,POINT (-87.638812 41.776931),60621-20210210
60621,02/11/2021,61,1542,39,1265,0.045,22,277,0.01,28018,POINT (-87.638812 41.776931),60621-20210211
60626,02/12/2021,479,7648,202,5435,0.108,277,2213,0.044,50544,POINT (-87.669834 42.009469),60626-20210212
60626,02/13/2021,259,7907,217,5652,0.112,42,2255,0.045,50544,POINT (-87.669834 42.009469),60626-20210213
60626,02/14/2021,41,7948,29,5681,0.112,12,2267,0.045,50544,POINT (-87.669834 42.009469),60626-20210214
60626,02/15/2021,325,8273,119,5800,0.115,206,2473,0.049,50544,POINT (-87.669834 42.009469),60626-20210215
60626,02/16/2021,115,8388,73,5873,0.116,42,2515,0.05,50544,POINT (-87.669834 42.009469),60626-20210216
60626,02/17/2021,197,8585,95,5968,0.118,102,2617,0.052,50544,POINT (-87.669834 42.009469),60626-20210217
60628,02/12/2021,242,4674,157,3784,0.059,85,890,0.014,64254,POINT (-87.621537 41.694192),60628-20210212
60628,02/13/2021,196,4870,148,3932,0.061,48,938,0.015,64254,POINT (-87.621537 41.694192),60628-20210213
60628,02/14/2021,32,4902,27,3959,0.062,5,943,0.015,64254,POINT (-87.621537 41.694192),60628-20210214
60628,02/15/2021,132,5034,80,4039,0.063,52,995,0.015,64254,POINT (-87.621537 41.694192),60628-20210215
60628,02/16/2021,89,5123,40,4079,0.063,49,1044,0.016,64254,POINT (-87.621537 41.694192),60628-20210216
60628,02/17/2021,264,5387,92,4171,0.065,172,1216,0.019,64254,POINT (-87.621537 41.694192),60628-20210217
60628,02/18/2021,225,5612,111,4282,0.067,114,1330,0.021,64254,POINT (-87.621537 41.694192),60628-20210218
60628,02/19/2021,287,5899,137,4419,0.069,150,1480,0.023,64254,POINT (-87.621537 41.694192),60628-20210219
60628,02/20/2021,129,6028,61,4480,0.07,68,1548,0.024,64254,POINT (-87.621537 41.694192),60628-20210220
60628,02/21/2021,57,6085,41,4521,0.07,16,1564,0.024,64254,POINT (-87.621537 41.694192),60628-20210221
60628,02/22/2021,199,6284,122,4643,0.072,77,1641,0.026,64254,POINT (-87.621537 41.694192),60628-20210222
60628,02/23/2021,206,6490,111,4754,0.074,95,1736,0.027,64254,POINT (-87.621537 41.694192),60628-20210223
60628,02/24/2021,211,6701,119,4873,0.076,92,1828,0.028,64254,POINT (-87.621537 41.694192),60628-20210224
60628,02/25/2021,316,7017,135,5008,0.078,181,2009,0.031,64254,POINT (-87.621537 41.694192),60628-20210225
60628,02/26/2021,334,7351,179,5187,0.081,155,2164,0.034,64254,POINT (-87.621537 41.694192),60628-20210226
60628,02/27/2021,248,7599,170,5357,0.083,78,2242,0.035,64254,POINT (-87.621537 41.694192),60628-20210227
60628,02/28/2021,165,7764,107,5464,0.085,58,2300,0.036,64254,POINT (-87.621537 41.694192),60628-20210228
60628,03/01/2021,276,8040,159,5623,0.088,117,2417,0.038,64254,POINT (-87.621537 41.694192),60628-20210301
60628,03/02/2021,288,8328,103,5726,0.089,185,2602,0.04,64254,POINT (-87.621537 41.694192),60628-20210302
60628,03/03/2021,328,8656,156,5882,0.092,172,2774,0.043,64254,POINT (-87.621537 41.694192),60628-20210303
60629,02/01/2021,211,3945,180,3277,0.03,31,668,0.006,110029,POINT (-87.711565 41.777061),60629-20210201
60629,02/02/2021,284,4229,230,3507,0.032,54,722,0.007,110029,POINT (-87.711565 41.777061),60629-20210202
60629,02/03/2021,375,4604,307,3814,0.035,68,790,0.007,110029,POINT (-87.711565 41.777061),60629-20210203
60629,02/04/2021,438,5042,379,4193,0.038,59,849,0.008,110029,POINT (-87.711565 41.777061),60629-20210204
60629,02/05/2021,503,5545,446,4639,0.042,57,906,0.008,110029,POINT (-87.711565 41.777061),60629-20210205
60629,02/06/2021,267,5812,229,4868,0.044,38,944,0.009,110029,POINT (-87.711565 41.777061),60629-20210206
60629,02/07/2021,54,5866,52,4920,0.045,2,946,0.009,110029,POINT (-87.711565 41.777061),60629-20210207
60629,02/08/2021,372,6238,339,5259,0.048,33,979,0.009,110029,POINT (-87.711565 41.777061),60629-20210208
60629,02/09/2021,371,6609,326,5585,0.051,45,1024,0.009,110029,POINT (-87.711565 41.777061),60629-20210209
60629,02/10/2021,456,7065,392,5977,0.054,64,1088,0.01,110029,POINT (-87.711565 41.777061),60629-20210210
60629,02/11/2021,562,7627,425,6402,0.058,137,1225,0.011,110029,POINT (-87.711565 41.777061),60629-20210211
60629,02/12/2021,464,8091,371,6773,0.062,93,1318,0.012,110029,POINT (-87.711565 41.777061),60629-20210212
60623,02/02/2021,255,3356,222,2829,0.035,33,527,0.006,81283,POINT (-87.717446 41.850321),60623-20210202
60623,02/03/2021,433,3789,339,3168,0.039,94,621,0.008,81283,POINT (-87.717446 41.850321),60623-20210203
60623,02/04/2021,326,4115,273,3441,0.042,53,674,0.008,81283,POINT (-87.717446 41.850321),60623-20210204
60629,02/13/2021,399,8490,261,7034,0.064,138,1456,0.013,110029,POINT (-87.711565 41.777061),60629-20210213
60629,02/14/2021,48,8538,34,7068,0.064,14,1470,0.013,110029,POINT (-87.711565 41.777061),60629-20210214
60629,02/15/2021,385,8923,333,7401,0.067,52,1522,0.014,110029,POINT (-87.711565 41.777061),60629-20210215
60630,02/09/2021,232,6026,179,4689,0.083,53,1337,0.024,56433,POINT (-87.759611 41.971261),60630-20210209
60630,02/10/2021,339,6365,273,4962,0.088,66,1403,0.025,56433,POINT (-87.759611 41.971261),60630-20210210
60630,02/11/2021,382,6747,267,5229,0.093,115,1518,0.027,56433,POINT (-87.759611 41.971261),60630-20210211
60625,01/29/2021,288,5789,262,4529,0.057,26,1260,0.016,79444,POINT (-87.701816 41.971155),60625-20210129
60625,01/30/2021,237,6026,205,4734,0.06,32,1292,0.016,79444,POINT (-87.701816 41.971155),60625-20210130
60625,01/31/2021,244,6270,159,4893,0.062,85,1377,0.017,79444,POINT (-87.701816 41.971155),60625-20210131
60625,02/01/2021,224,6494,168,5061,0.064,56,1433,0.018,79444,POINT (-87.701816 41.971155),60625-20210201
60625,02/02/2021,348,6842,247,5308,0.067,101,1534,0.019,79444,POINT (-87.701816 41.971155),60625-20210202
60625,02/03/2021,389,7231,273,5581,0.07,116,1650,0.021,79444,POINT (-87.701816 41.971155),60625-20210203
60630,02/12/2021,352,7099,266,5495,0.097,86,1604,0.028,56433,POINT (-87.759611 41.971261),60630-20210212
60630,02/13/2021,290,7389,206,5701,0.101,84,1688,0.03,56433,POINT (-87.759611 41.971261),60630-20210213
60630,02/14/2021,83,7472,66,5767,0.102,17,1705,0.03,56433,POINT (-87.759611 41.971261),60630-20210214
60630,02/15/2021,195,7667,164,5931,0.105,31,1736,0.031,56433,POINT (-87.759611 41.971261),60630-20210215
60630,02/16/2021,159,7826,124,6055,0.107,35,1771,0.031,56433,POINT (-87.759611 41.971261),60630-20210216
60630,02/17/2021,323,8149,183,6238,0.111,140,1911,0.034,56433,POINT (-87.759611 41.971261),60630-20210217
60630,02/18/2021,328,8477,181,6419,0.114,147,2058,0.036,56433,POINT (-87.759611 41.971261),60630-20210218
60631,02/09/2021,211,5185,165,4127,0.14,46,1058,0.036,29529,POINT (-87.813371 41.995019),60631-20210209
60631,02/10/2021,293,5478,194,4321,0.146,99,1157,0.039,29529,POINT (-87.813371 41.995019),60631-20210210
60631,02/11/2021,291,5769,198,4519,0.153,93,1250,0.042,29529,POINT (-87.813371 41.995019),60631-20210211
60631,02/12/2021,276,6045,220,4739,0.16,56,1306,0.044,29529,POINT (-87.813371 41.995019),60631-20210212
60630,02/19/2021,305,8782,147,6566,0.116,158,2216,0.039,56433,POINT (-87.759611 41.971261),60630-20210219
60630,02/20/2021,180,8962,85,6651,0.118,95,2311,0.041,56433,POINT (-87.759611 41.971261),60630-20210220
60630,02/21/2021,64,9026,29,6680,0.118,35,2346,0.042,56433,POINT (-87.759611 41.971261),60630-20210221
60630,02/22/2021,191,9217,67,6747,0.12,124,2470,0.044,56433,POINT (-87.759611 41.971261),60630-20210222
60630,02/23/2021,314,9531,168,6915,0.123,146,2616,0.046,56433,POINT (-87.759611 41.971261),60630-20210223
60630,02/24/2021,322,9853,154,7069,0.125,168,2784,0.049,56433,POINT (-87.759611 41.971261),60630-20210224
60633,02/28/2021,19,1370,4,969,0.076,15,401,0.032,12689,POINT (-87.556037 41.653147),60633-20210228
60633,03/01/2021,39,1409,15,984,0.078,24,425,0.033,12689,POINT (-87.556037 41.653147),60633-20210301
60633,03/02/2021,48,1457,24,1008,0.079,24,449,0.035,12689,POINT (-87.556037 41.653147),60633-20210302
60633,03/03/2021,44,1501,15,1023,0.081,29,478,0.038,12689,POINT (-87.556037 41.653147),60633-20210303
60633,03/04/2021,67,1568,32,1055,0.083,35,513,0.04,12689,POINT (-87.556037 41.653147),60633-20210304
60634,01/24/2021,41,3429,35,2803,0.037,6,626,0.008,75082,POINT (-87.797373 41.944967),60634-20210124
60634,01/25/2021,195,3624,145,2948,0.039,50,676,0.009,75082,POINT (-87.797373 41.944967),60634-20210125
60634,01/26/2021,183,3807,117,3065,0.041,66,742,0.01,75082,POINT (-87.797373 41.944967),60634-20210126
60634,01/27/2021,232,4039,177,3242,0.043,55,797,0.011,75082,POINT (-87.797373 41.944967),60634-20210127
60634,01/28/2021,292,4331,230,3472,0.046,62,859,0.011,75082,POINT (-87.797373 41.944967),60634-20210128
60634,01/29/2021,203,4534,180,3652,0.049,23,882,0.012,75082,POINT (-87.797373 41.944967),60634-20210129
60634,01/30/2021,231,4765,138,3790,0.05,93,975,0.013,75082,POINT (-87.797373 41.944967),60634-20210130
60634,01/31/2021,54,4819,45,3835,0.051,9,984,0.013,75082,POINT (-87.797373 41.944967),60634-20210131
60634,02/03/2021,319,5662,245,4463,0.059,74,1199,0.016,75082,POINT (-87.797373 41.944967),60634-20210203
60634,02/04/2021,378,6040,314,4777,0.064,64,1263,0.017,75082,POINT (-87.797373 41.944967),60634-20210204
60634,02/05/2021,571,6611,334,5111,0.068,237,1500,0.02,75082,POINT (-87.797373 41.944967),60634-20210205
60634,02/06/2021,295,6906,265,5376,0.072,30,1530,0.02,75082,POINT (-87.797373 41.944967),60634-20210206
60634,02/07/2021,72,6978,56,5432,0.072,16,1546,0.021,75082,POINT (-87.797373 41.944967),60634-20210207
60634,02/08/2021,257,7235,210,5642,0.075,47,1593,0.021,75082,POINT (-87.797373 41.944967),60634-20210208
60634,02/09/2021,359,7594,284,5926,0.079,75,1668,0.022,75082,POINT (-87.797373 41.944967),60634-20210209
60634,02/10/2021,427,8021,286,6212,0.083,141,1809,0.024,75082,POINT (-87.797373 41.944967),60634-20210210
60634,02/11/2021,528,8549,360,6572,0.088,168,1977,0.026,75082,POINT (-87.797373 41.944967),60634-20210211
60634,02/12/2021,470,9019,349,6921,0.092,121,2098,0.028,75082,POINT (-87.797373 41.944967),60634-20210212
60634,02/13/2021,452,9471,308,7229,0.096,144,2242,0.03,75082,POINT (-87.797373 41.944967),60634-20210213
60634,02/14/2021,152,9623,136,7365,0.098,16,2258,0.03,75082,POINT (-87.797373 41.944967),60634-20210214
60634,02/15/2021,211,9834,169,7534,0.1,42,2300,0.031,75082,POINT (-87.797373 41.944967),60634-20210215
60634,02/16/2021,199,10033,141,7675,0.102,58,2358,0.031,75082,POINT (-87.797373 41.944967),60634-20210216
60634,02/17/2021,396,10429,224,7899,0.105,172,2530,0.034,75082,POINT (-87.797373 41.944967),60634-20210217
60634,02/18/2021,389,10818,200,8099,0.108,189,2719,0.036,75082,POINT (-87.797373 41.944967),60634-20210218
60637,02/01/2021,83,3909,58,3033,0.064,25,876,0.019,47300,POINT (-87.604053 41.780991),60637-20210201
60637,02/02/2021,96,4005,78,3111,0.066,18,894,0.019,47300,POINT (-87.604053 41.780991),60637-20210202
60637,02/03/2021,198,4203,154,3265,0.069,44,938,0.02,47300,POINT (-87.604053 41.780991),60637-20210203
60637,02/04/2021,185,4388,109,3374,0.071,76,1014,0.021,47300,POINT (-87.604053 41.780991),60637-20210204
60637,02/05/2021,178,4566,107,3481,0.074,71,1085,0.023,47300,POINT (-87.604053 41.780991),60637-20210205
60637,02/06/2021,124,4690,64,3545,0.075,60,1145,0.024,47300,POINT (-87.604053 41.780991),60637-20210206
60637,02/07/2021,76,4766,75,3620,0.077,1,1146,0.024,47300,POINT (-87.604053 41.780991),60637-20210207
60637,02/08/2021,182,4948,70,3690,0.078,112,1258,0.027,47300,POINT (-87.604053 41.780991),60637-20210208
60637,02/09/2021,146,5094,47,3737,0.079,99,1357,0.029,47300,POINT (-87.604053 41.780991),60637-20210209
60637,02/10/2021,201,5295,91,3828,0.081,110,1467,0.031,47300,POINT (-87.604053 41.780991),60637-20210210
60637,02/11/2021,291,5586,82,3910,0.083,209,1676,0.035,47300,POINT (-87.604053 41.780991),60637-20210211
60637,02/12/2021,303,5889,78,3988,0.084,225,1901,0.04,47300,POINT (-87.604053 41.780991),60637-20210212
60637,02/13/2021,140,6029,70,4058,0.086,70,1971,0.042,47300,POINT (-87.604053 41.780991),60637-20210213
60637,02/14/2021,14,6043,14,4072,0.086,0,1971,0.042,47300,POINT (-87.604053 41.780991),60637-20210214
60637,02/15/2021,118,6161,43,4115,0.087,75,2046,0.043,47300,POINT (-87.604053 41.780991),60637-20210215
60637,02/16/2021,132,6293,47,4162,0.088,85,2131,0.045,47300,POINT (-87.604053 41.780991),60637-20210216
60637,02/17/2021,130,6423,34,4196,0.089,96,2227,0.047,47300,POINT (-87.604053 41.780991),60637-20210217
60637,02/18/2021,138,6561,47,4243,0.09,91,2318,0.049,47300,POINT (-87.604053 41.780991),60637-20210218
60637,02/19/2021,161,6722,54,4297,0.091,107,2425,0.051,47300,POINT (-87.604053 41.780991),60637-20210219
60637,02/20/2021,51,6773,10,4307,0.091,41,2466,0.052,47300,POINT (-87.604053 41.780991),60637-20210220
60637,02/21/2021,80,6853,12,4319,0.091,68,2534,0.054,47300,POINT (-87.604053 41.780991),60637-20210221
60637,02/22/2021,198,7051,90,4409,0.093,108,2642,0.056,47300,POINT (-87.604053 41.780991),60637-20210222
60637,02/23/2021,134,7185,55,4464,0.094,79,2721,0.058,47300,POINT (-87.604053 41.780991),60637-20210223
60637,02/24/2021,127,7312,53,4517,0.095,74,2795,0.059,47300,POINT (-87.604053 41.780991),60637-20210224
60637,02/25/2021,177,7489,74,4591,0.097,103,2898,0.061,47300,POINT (-87.604053 41.780991),60637-20210225
60637,02/26/2021,226,7715,123,4714,0.1,103,3001,0.063,47300,POINT (-87.604053 41.780991),60637-20210226
60638,01/21/2021,154,1843,129,1399,0.024,25,444,0.008,58669,POINT (-87.771902 41.787032),60638-20210121
60631,02/01/2021,123,3362,92,2653,0.09,31,709,0.024,29529,POINT (-87.813371 41.995019),60631-20210201
60638,01/22/2021,166,2009,152,1551,0.026,14,458,0.008,58669,POINT (-87.771902 41.787032),60638-20210122
60638,01/23/2021,115,2124,112,1663,0.028,3,461,0.008,58669,POINT (-87.771902 41.787032),60638-20210123
60638,01/24/2021,33,2157,31,1694,0.029,2,463,0.008,58669,POINT (-87.771902 41.787032),60638-20210124
60638,01/25/2021,124,2281,89,1783,0.03,35,498,0.008,58669,POINT (-87.771902 41.787032),60638-20210125
60638,01/26/2021,150,2431,104,1887,0.032,46,544,0.009,58669,POINT (-87.771902 41.787032),60638-20210126
60638,01/27/2021,209,2640,183,2070,0.035,26,570,0.01,58669,POINT (-87.771902 41.787032),60638-20210127
60638,01/28/2021,220,2860,189,2259,0.039,31,601,0.01,58669,POINT (-87.771902 41.787032),60638-20210128
60638,01/29/2021,246,3106,223,2482,0.042,23,624,0.011,58669,POINT (-87.771902 41.787032),60638-20210129
60632,02/01/2021,211,3254,187,2745,0.031,24,509,0.006,89857,POINT (-87.711251 41.810038),60632-20210201
60638,01/30/2021,155,3261,135,2617,0.045,20,644,0.011,58669,POINT (-87.771902 41.787032),60638-20210130
60638,01/31/2021,28,3289,22,2639,0.045,6,650,0.011,58669,POINT (-87.771902 41.787032),60638-20210131
60638,02/01/2021,166,3455,142,2781,0.047,24,674,0.011,58669,POINT (-87.771902 41.787032),60638-20210201
60638,02/02/2021,256,3711,201,2982,0.051,55,729,0.012,58669,POINT (-87.771902 41.787032),60638-20210202
60638,02/03/2021,288,3999,242,3224,0.055,46,775,0.013,58669,POINT (-87.771902 41.787032),60638-20210203
60638,02/04/2021,320,4319,289,3513,0.06,31,806,0.014,58669,POINT (-87.771902 41.787032),60638-20210204
60638,02/05/2021,327,4646,284,3797,0.065,43,849,0.014,58669,POINT (-87.771902 41.787032),60638-20210205
60638,02/06/2021,183,4829,158,3955,0.067,25,874,0.015,58669,POINT (-87.771902 41.787032),60638-20210206
60638,02/07/2021,52,4881,50,4005,0.068,2,876,0.015,58669,POINT (-87.771902 41.787032),60638-20210207
60638,02/08/2021,217,5098,184,4189,0.071,33,909,0.015,58669,POINT (-87.771902 41.787032),60638-20210208
60638,02/09/2021,312,5410,251,4440,0.076,61,970,0.017,58669,POINT (-87.771902 41.787032),60638-20210209
60638,02/10/2021,349,5759,273,4713,0.08,76,1046,0.018,58669,POINT (-87.771902 41.787032),60638-20210210
60638,02/11/2021,367,6126,260,4973,0.085,107,1153,0.02,58669,POINT (-87.771902 41.787032),60638-20210211
60638,02/12/2021,354,6480,278,5251,0.09,76,1229,0.021,58669,POINT (-87.771902 41.787032),60638-20210212
60632,02/02/2021,293,3547,249,2994,0.033,44,553,0.006,89857,POINT (-87.711251 41.810038),60632-20210202
60638,02/13/2021,239,6719,153,5404,0.092,86,1315,0.022,58669,POINT (-87.771902 41.787032),60638-20210213
60639,01/19/2021,73,1510,52,1268,0.014,21,242,0.003,88204,POINT (-87.75531 41.920609),60639-20210119
60639,02/04/2021,317,4133,271,3385,0.038,46,748,0.008,88204,POINT (-87.75531 41.920609),60639-20210204
60633,02/26/2021,74,1321,40,951,0.075,34,370,0.029,12689,POINT (-87.556037 41.653147),60633-20210226
60633,02/27/2021,30,1351,14,965,0.076,16,386,0.03,12689,POINT (-87.556037 41.653147),60633-20210227
60634,01/10/2021,30,1669,13,1424,0.019,17,245,0.003,75082,POINT (-87.797373 41.944967),60634-20210110
60634,01/11/2021,104,1773,49,1473,0.02,55,300,0.004,75082,POINT (-87.797373 41.944967),60634-20210111
60634,01/12/2021,129,1902,72,1545,0.021,57,357,0.005,75082,POINT (-87.797373 41.944967),60634-20210112
60634,01/13/2021,148,2050,97,1642,0.022,51,408,0.005,75082,POINT (-87.797373 41.944967),60634-20210113
60634,01/14/2021,87,2137,75,1717,0.023,12,420,0.006,75082,POINT (-87.797373 41.944967),60634-20210114
60634,01/15/2021,198,2335,197,1914,0.025,1,421,0.006,75082,POINT (-87.797373 41.944967),60634-20210115
60634,01/16/2021,152,2487,144,2058,0.027,8,429,0.006,75082,POINT (-87.797373 41.944967),60634-20210116
60634,01/17/2021,23,2510,11,2069,0.028,12,441,0.006,75082,POINT (-87.797373 41.944967),60634-20210117
60634,01/18/2021,60,2570,44,2113,0.028,16,457,0.006,75082,POINT (-87.797373 41.944967),60634-20210118
60634,01/19/2021,136,2706,88,2201,0.029,48,505,0.007,75082,POINT (-87.797373 41.944967),60634-20210119
60634,01/20/2021,224,2930,173,2374,0.032,51,556,0.007,75082,POINT (-87.797373 41.944967),60634-20210120
60634,01/21/2021,176,3106,137,2511,0.033,39,595,0.008,75082,POINT (-87.797373 41.944967),60634-20210121
60634,01/22/2021,177,3283,165,2676,0.036,12,607,0.008,75082,POINT (-87.797373 41.944967),60634-20210122
60634,01/23/2021,105,3388,92,2768,0.037,13,620,0.008,75082,POINT (-87.797373 41.944967),60634-20210123
60634,01/09/2021,74,1639,32,1411,0.019,42,228,0.003,75082,POINT (-87.797373 41.944967),60634-20210109
60639,02/14/2021,715,7963,711,6644,0.075,4,1319,0.015,88204,POINT (-87.75531 41.920609),60639-20210214
60639,02/15/2021,191,8154,145,6789,0.077,46,1365,0.015,88204,POINT (-87.75531 41.920609),60639-20210215
60634,02/01/2021,193,5012,146,3981,0.053,47,1031,0.014,75082,POINT (-87.797373 41.944967),60634-20210201
60634,02/02/2021,331,5343,237,4218,0.056,94,1125,0.015,75082,POINT (-87.797373 41.944967),60634-20210202
60639,02/05/2021,321,4454,268,3653,0.041,53,801,0.009,88204,POINT (-87.75531 41.920609),60639-20210205
60639,02/06/2021,326,4780,289,3942,0.045,37,838,0.01,88204,POINT (-87.75531 41.920609),60639-20210206
60639,02/07/2021,115,4895,59,4001,0.045,56,894,0.01,88204,POINT (-87.75531 41.920609),60639-20210207
60639,02/08/2021,247,5142,173,4174,0.047,74,968,0.011,88204,POINT (-87.75531 41.920609),60639-20210208
60639,02/09/2021,252,5394,202,4376,0.05,50,1018,0.012,88204,POINT (-87.75531 41.920609),60639-20210209
60639,02/10/2021,285,5679,218,4594,0.052,67,1085,0.012,88204,POINT (-87.75531 41.920609),60639-20210210
60639,02/11/2021,340,6019,234,4828,0.055,106,1191,0.014,88204,POINT (-87.75531 41.920609),60639-20210211
60639,02/12/2021,336,6355,255,5083,0.058,81,1272,0.014,88204,POINT (-87.75531 41.920609),60639-20210212
60639,02/13/2021,893,7248,850,5933,0.067,43,1315,0.015,88204,POINT (-87.75531 41.920609),60639-20210213
60640,01/26/2021,331,6176,230,4976,0.072,101,1200,0.017,69363,POINT (-87.662232 41.971888),60640-20210126
60640,01/27/2021,653,6829,489,5465,0.079,164,1364,0.02,69363,POINT (-87.662232 41.971888),60640-20210127
60640,01/28/2021,537,7366,479,5944,0.086,58,1422,0.021,69363,POINT (-87.662232 41.971888),60640-20210128
60640,01/29/2021,434,7800,395,6339,0.091,39,1461,0.021,69363,POINT (-87.662232 41.971888),60640-20210129
60640,02/03/2021,533,9335,318,7316,0.105,215,2019,0.029,69363,POINT (-87.662232 41.971888),60640-20210203
60640,02/04/2021,486,9821,326,7642,0.11,160,2179,0.031,69363,POINT (-87.662232 41.971888),60640-20210204
60640,02/05/2021,655,10476,361,8003,0.115,294,2473,0.036,69363,POINT (-87.662232 41.971888),60640-20210205
60640,02/06/2021,224,10700,145,8148,0.117,79,2552,0.037,69363,POINT (-87.662232 41.971888),60640-20210206
60640,02/07/2021,68,10768,55,8203,0.118,13,2565,0.037,69363,POINT (-87.662232 41.971888),60640-20210207
60640,02/08/2021,396,11164,244,8447,0.122,152,2717,0.039,69363,POINT (-87.662232 41.971888),60640-20210208
60640,02/09/2021,325,11489,231,8678,0.125,94,2811,0.041,69363,POINT (-87.662232 41.971888),60640-20210209
60640,02/10/2021,566,12055,326,9004,0.13,240,3051,0.044,69363,POINT (-87.662232 41.971888),60640-20210210
60640,02/11/2021,541,12596,278,9282,0.134,263,3314,0.048,69363,POINT (-87.662232 41.971888),60640-20210211
60640,02/12/2021,481,13077,316,9598,0.138,165,3479,0.05,69363,POINT (-87.662232 41.971888),60640-20210212
60640,02/13/2021,297,13374,215,9813,0.141,82,3561,0.051,69363,POINT (-87.662232 41.971888),60640-20210213
60640,02/14/2021,119,13493,80,9893,0.143,39,3600,0.052,69363,POINT (-87.662232 41.971888),60640-20210214
60640,02/15/2021,217,13710,154,10047,0.145,63,3663,0.053,69363,POINT (-87.662232 41.971888),60640-20210215
60640,02/16/2021,269,13979,213,10260,0.148,56,3719,0.054,69363,POINT (-87.662232 41.971888),60640-20210216
60640,02/17/2021,466,14445,214,10474,0.151,252,3971,0.057,69363,POINT (-87.662232 41.971888),60640-20210217
60641,02/01/2021,245,4388,171,3458,0.049,74,930,0.013,69880,POINT (-87.746791 41.946682),60641-20210201
60641,02/02/2021,266,4654,181,3639,0.052,85,1015,0.015,69880,POINT (-87.746791 41.946682),60641-20210202
60641,02/03/2021,293,4947,222,3861,0.055,71,1086,0.016,69880,POINT (-87.746791 41.946682),60641-20210203
60641,02/04/2021,310,5257,258,4119,0.059,52,1138,0.016,69880,POINT (-87.746791 41.946682),60641-20210204
60641,02/05/2021,360,5617,282,4401,0.063,78,1216,0.017,69880,POINT (-87.746791 41.946682),60641-20210205
60641,02/06/2021,316,5933,257,4658,0.067,59,1275,0.018,69880,POINT (-87.746791 41.946682),60641-20210206
60641,02/07/2021,68,6001,56,4714,0.067,12,1287,0.018,69880,POINT (-87.746791 41.946682),60641-20210207
60641,02/08/2021,240,6241,206,4920,0.07,34,1321,0.019,69880,POINT (-87.746791 41.946682),60641-20210208
60641,02/09/2021,271,6512,219,5139,0.074,52,1373,0.02,69880,POINT (-87.746791 41.946682),60641-20210209
60641,02/10/2021,361,6873,269,5408,0.077,92,1465,0.021,69880,POINT (-87.746791 41.946682),60641-20210210
60641,02/11/2021,416,7289,297,5705,0.082,119,1584,0.023,69880,POINT (-87.746791 41.946682),60641-20210211
60641,02/12/2021,409,7698,313,6018,0.086,96,1680,0.024,69880,POINT (-87.746791 41.946682),60641-20210212
60641,02/13/2021,289,7987,219,6237,0.089,70,1750,0.025,69880,POINT (-87.746791 41.946682),60641-20210213
60641,02/14/2021,83,8070,66,6303,0.09,17,1767,0.025,69880,POINT (-87.746791 41.946682),60641-20210214
60641,02/15/2021,223,8293,160,6463,0.092,63,1830,0.026,69880,POINT (-87.746791 41.946682),60641-20210215
60639,01/20/2021,160,1670,117,1385,0.016,43,285,0.003,88204,POINT (-87.75531 41.920609),60639-20210120
60639,01/21/2021,175,1845,150,1535,0.017,25,310,0.004,88204,POINT (-87.75531 41.920609),60639-20210121
60641,02/16/2021,181,8474,119,6582,0.094,62,1892,0.027,69880,POINT (-87.746791 41.946682),60641-20210216
60641,02/17/2021,300,8774,168,6750,0.097,132,2024,0.029,69880,POINT (-87.746791 41.946682),60641-20210217
60641,02/18/2021,368,9142,199,6949,0.099,169,2193,0.031,69880,POINT (-87.746791 41.946682),60641-20210218
60642,02/05/2021,111,3165,75,2175,0.11,36,990,0.05,19716,POINT (-87.657821 41.899935),60642-20210205
60642,02/06/2021,82,3247,53,2228,0.113,29,1019,0.052,19716,POINT (-87.657821 41.899935),60642-20210206
60642,02/07/2021,24,3271,17,2245,0.114,7,1026,0.052,19716,POINT (-87.657821 41.899935),60642-20210207
60642,02/08/2021,89,3360,67,2312,0.117,22,1048,0.053,19716,POINT (-87.657821 41.899935),60642-20210208
60642,02/09/2021,100,3460,65,2377,0.121,35,1083,0.055,19716,POINT (-87.657821 41.899935),60642-20210209
60642,02/10/2021,109,3569,73,2450,0.124,36,1119,0.057,19716,POINT (-87.657821 41.899935),60642-20210210
60642,02/11/2021,125,3694,67,2517,0.128,58,1177,0.06,19716,POINT (-87.657821 41.899935),60642-20210211
60642,02/12/2021,115,3809,69,2586,0.131,46,1223,0.062,19716,POINT (-87.657821 41.899935),60642-20210212
60642,02/13/2021,98,3907,64,2650,0.134,34,1257,0.064,19716,POINT (-87.657821 41.899935),60642-20210213
60642,02/14/2021,18,3925,11,2661,0.135,7,1264,0.064,19716,POINT (-87.657821 41.899935),60642-20210214
60642,02/15/2021,51,3976,26,2687,0.136,25,1289,0.065,19716,POINT (-87.657821 41.899935),60642-20210215
60642,02/16/2021,65,4041,42,2729,0.138,23,1312,0.067,19716,POINT (-87.657821 41.899935),60642-20210216
60642,02/17/2021,105,4146,51,2780,0.141,54,1366,0.069,19716,POINT (-87.657821 41.899935),60642-20210217
60642,02/18/2021,101,4247,40,2820,0.143,61,1427,0.072,19716,POINT (-87.657821 41.899935),60642-20210218
60642,02/19/2021,106,4353,44,2864,0.145,62,1489,0.076,19716,POINT (-87.657821 41.899935),60642-20210219
60642,02/20/2021,54,4407,19,2883,0.146,35,1524,0.077,19716,POINT (-87.657821 41.899935),60642-20210220
60642,02/21/2021,31,4438,12,2895,0.147,19,1543,0.078,19716,POINT (-87.657821 41.899935),60642-20210221
60642,02/22/2021,81,4519,26,2921,0.148,55,1598,0.081,19716,POINT (-87.657821 41.899935),60642-20210222
60642,02/23/2021,105,4624,47,2968,0.151,58,1656,0.084,19716,POINT (-87.657821 41.899935),60642-20210223
60641,02/19/2021,355,9497,189,7138,0.102,166,2359,0.034,69880,POINT (-87.746791 41.946682),60641-20210219
60641,02/20/2021,239,9736,110,7248,0.104,129,2488,0.036,69880,POINT (-87.746791 41.946682),60641-20210220
60642,03/02/2021,101,5328,49,3303,0.168,52,2025,0.103,19716,POINT (-87.657821 41.899935),60642-20210302
60642,03/03/2021,139,5467,66,3369,0.171,73,2098,0.106,19716,POINT (-87.657821 41.899935),60642-20210303
60642,03/04/2021,126,5593,64,3433,0.174,62,2160,0.11,19716,POINT (-87.657821 41.899935),60642-20210304
60642,03/05/2021,141,5734,89,3522,0.179,52,2212,0.112,19716,POINT (-87.657821 41.899935),60642-20210305
60639,01/22/2021,152,1997,145,1680,0.019,7,317,0.004,88204,POINT (-87.75531 41.920609),60639-20210122
60639,01/23/2021,59,2056,48,1728,0.02,11,328,0.004,88204,POINT (-87.75531 41.920609),60639-20210123
60639,01/24/2021,16,2072,14,1742,0.02,2,330,0.004,88204,POINT (-87.75531 41.920609),60639-20210124
60639,01/25/2021,121,2193,79,1821,0.021,42,372,0.004,88204,POINT (-87.75531 41.920609),60639-20210125
60639,01/26/2021,136,2329,95,1916,0.022,41,413,0.005,88204,POINT (-87.75531 41.920609),60639-20210126
60639,01/27/2021,193,2522,144,2060,0.023,49,462,0.005,88204,POINT (-87.75531 41.920609),60639-20210127
60639,01/28/2021,196,2718,161,2221,0.025,35,497,0.006,88204,POINT (-87.75531 41.920609),60639-20210128
60639,01/29/2021,202,2920,170,2391,0.027,32,529,0.006,88204,POINT (-87.75531 41.920609),60639-20210129
60639,01/30/2021,156,3076,139,2530,0.029,17,546,0.006,88204,POINT (-87.75531 41.920609),60639-20210130
60639,01/31/2021,41,3117,34,2564,0.029,7,553,0.006,88204,POINT (-87.75531 41.920609),60639-20210131
60639,02/01/2021,175,3292,146,2710,0.031,29,582,0.007,88204,POINT (-87.75531 41.920609),60639-20210201
60639,02/02/2021,245,3537,182,2892,0.033,63,645,0.007,88204,POINT (-87.75531 41.920609),60639-20210202
60639,02/03/2021,279,3816,222,3114,0.035,57,702,0.008,88204,POINT (-87.75531 41.920609),60639-20210203
60642,02/24/2021,114,4738,52,3020,0.153,62,1718,0.087,19716,POINT (-87.657821 41.899935),60642-20210224
60642,02/25/2021,136,4874,64,3084,0.156,72,1790,0.091,19716,POINT (-87.657821 41.899935),60642-20210225
60642,02/26/2021,147,5021,64,3148,0.16,83,1873,0.095,19716,POINT (-87.657821 41.899935),60642-20210226
60642,02/27/2021,99,5120,59,3207,0.163,40,1913,0.097,19716,POINT (-87.657821 41.899935),60642-20210227
60642,02/28/2021,30,5150,14,3221,0.163,16,1929,0.098,19716,POINT (-87.657821 41.899935),60642-20210228
60642,03/01/2021,77,5227,33,3254,0.165,44,1973,0.1,19716,POINT (-87.657821 41.899935),60642-20210301
60643,02/05/2021,300,4963,243,4125,0.084,57,838,0.017,48887,POINT (-87.662381 41.700445),60643-20210205
60643,02/06/2021,176,5139,154,4279,0.088,22,860,0.018,48887,POINT (-87.662381 41.700445),60643-20210206
60643,02/07/2021,62,5201,59,4338,0.089,3,863,0.018,48887,POINT (-87.662381 41.700445),60643-20210207
60643,02/08/2021,253,5454,187,4525,0.093,66,929,0.019,48887,POINT (-87.662381 41.700445),60643-20210208
60643,02/09/2021,274,5728,190,4715,0.096,84,1013,0.021,48887,POINT (-87.662381 41.700445),60643-20210209
60643,02/27/2021,300,10941,168,7184,0.147,132,3757,0.077,48887,POINT (-87.662381 41.700445),60643-20210227
60643,02/28/2021,130,11071,76,7260,0.149,54,3811,0.078,48887,POINT (-87.662381 41.700445),60643-20210228
60643,03/01/2021,211,11282,90,7350,0.15,121,3932,0.08,48887,POINT (-87.662381 41.700445),60643-20210301
60643,03/02/2021,306,11588,119,7469,0.153,187,4119,0.084,48887,POINT (-87.662381 41.700445),60643-20210302
60640,01/30/2021,162,7962,132,6471,0.093,30,1491,0.021,69363,POINT (-87.662232 41.971888),60640-20210130
60640,01/31/2021,141,8103,66,6537,0.094,75,1566,0.023,69363,POINT (-87.662232 41.971888),60640-20210131
60640,02/01/2021,387,8490,274,6811,0.098,113,1679,0.024,69363,POINT (-87.662232 41.971888),60640-20210201
60640,02/02/2021,312,8802,187,6998,0.101,125,1804,0.026,69363,POINT (-87.662232 41.971888),60640-20210202
60643,02/10/2021,571,6299,218,4933,0.101,353,1366,0.028,48887,POINT (-87.662381 41.700445),60643-20210210
60643,02/11/2021,405,6704,241,5174,0.106,164,1530,0.031,48887,POINT (-87.662381 41.700445),60643-20210211
60643,02/12/2021,325,7029,201,5375,0.11,124,1654,0.034,48887,POINT (-87.662381 41.700445),60643-20210212
60643,02/13/2021,325,7354,213,5588,0.114,112,1766,0.036,48887,POINT (-87.662381 41.700445),60643-20210213
60643,02/14/2021,60,7414,41,5629,0.115,19,1785,0.037,48887,POINT (-87.662381 41.700445),60643-20210214
60643,02/15/2021,134,7548,75,5704,0.117,59,1844,0.038,48887,POINT (-87.662381 41.700445),60643-20210215
60643,02/16/2021,147,7695,87,5791,0.118,60,1904,0.039,48887,POINT (-87.662381 41.700445),60643-20210216
60643,02/17/2021,299,7994,120,5911,0.121,179,2083,0.043,48887,POINT (-87.662381 41.700445),60643-20210217
60643,02/18/2021,354,8348,150,6061,0.124,204,2287,0.047,48887,POINT (-87.662381 41.700445),60643-20210218
60643,02/19/2021,340,8688,170,6231,0.127,170,2457,0.05,48887,POINT (-87.662381 41.700445),60643-20210219
60643,02/20/2021,196,8884,72,6303,0.129,124,2581,0.053,48887,POINT (-87.662381 41.700445),60643-20210220
60643,02/21/2021,75,8959,39,6342,0.13,36,2617,0.054,48887,POINT (-87.662381 41.700445),60643-20210221
60643,02/22/2021,220,9179,91,6433,0.132,129,2746,0.056,48887,POINT (-87.662381 41.700445),60643-20210222
60643,02/23/2021,313,9492,131,6564,0.134,182,2928,0.06,48887,POINT (-87.662381 41.700445),60643-20210223
60643,02/24/2021,308,9800,106,6670,0.136,202,3130,0.064,48887,POINT (-87.662381 41.700445),60643-20210224
60643,02/25/2021,408,10208,158,6828,0.14,250,3380,0.069,48887,POINT (-87.662381 41.700445),60643-20210225
60643,02/26/2021,433,10641,188,7016,0.144,245,3625,0.074,48887,POINT (-87.662381 41.700445),60643-20210226
60644,02/17/2021,106,4128,56,3201,0.069,50,927,0.02,46591,POINT (-87.756863 41.881113),60644-20210217
60644,02/18/2021,143,4271,87,3288,0.071,56,983,0.021,46591,POINT (-87.756863 41.881113),60644-20210218
60644,02/19/2021,126,4397,75,3363,0.072,51,1034,0.022,46591,POINT (-87.756863 41.881113),60644-20210219
60644,02/20/2021,68,4465,37,3400,0.073,31,1065,0.023,46591,POINT (-87.756863 41.881113),60644-20210220
60644,02/21/2021,5,4470,4,3404,0.073,1,1066,0.023,46591,POINT (-87.756863 41.881113),60644-20210221
60644,02/22/2021,113,4583,47,3451,0.074,66,1132,0.024,46591,POINT (-87.756863 41.881113),60644-20210222
60644,02/23/2021,107,4690,66,3517,0.075,41,1173,0.025,46591,POINT (-87.756863 41.881113),60644-20210223
60644,02/24/2021,156,4846,103,3620,0.078,53,1226,0.026,46591,POINT (-87.756863 41.881113),60644-20210224
60644,02/25/2021,209,5055,104,3724,0.08,105,1331,0.029,46591,POINT (-87.756863 41.881113),60644-20210225
60644,02/26/2021,174,5229,73,3797,0.081,101,1432,0.031,46591,POINT (-87.756863 41.881113),60644-20210226
60644,02/27/2021,159,5388,75,3872,0.083,84,1516,0.033,46591,POINT (-87.756863 41.881113),60644-20210227
60644,02/28/2021,26,5414,16,3888,0.083,10,1526,0.033,46591,POINT (-87.756863 41.881113),60644-20210228
60644,03/01/2021,158,5572,97,3985,0.086,61,1587,0.034,46591,POINT (-87.756863 41.881113),60644-20210301
60644,03/02/2021,185,5757,92,4077,0.088,93,1680,0.036,46591,POINT (-87.756863 41.881113),60644-20210302
60646,02/11/2021,274,5021,184,3926,0.137,90,1095,0.038,28569,POINT (-87.761826 41.993931),60646-20210211
60646,02/12/2021,259,5280,191,4117,0.144,68,1163,0.041,28569,POINT (-87.761826 41.993931),60646-20210212
60646,02/13/2021,150,5430,106,4223,0.148,44,1207,0.042,28569,POINT (-87.761826 41.993931),60646-20210213
60646,02/14/2021,72,5502,57,4280,0.15,15,1222,0.043,28569,POINT (-87.761826 41.993931),60646-20210214
60642,02/02/2021,106,2823,68,1923,0.098,38,900,0.046,19716,POINT (-87.657821 41.899935),60642-20210202
60642,02/03/2021,111,2934,78,2001,0.101,33,933,0.047,19716,POINT (-87.657821 41.899935),60642-20210203
60642,02/04/2021,120,3054,99,2100,0.107,21,954,0.048,19716,POINT (-87.657821 41.899935),60642-20210204
60646,02/15/2021,103,5605,71,4351,0.152,32,1254,0.044,28569,POINT (-87.761826 41.993931),60646-20210215
60646,02/16/2021,143,5748,95,4446,0.156,48,1302,0.046,28569,POINT (-87.761826 41.993931),60646-20210216
60646,02/17/2021,203,5951,118,4564,0.16,85,1387,0.049,28569,POINT (-87.761826 41.993931),60646-20210217
60646,02/18/2021,304,6255,130,4694,0.164,174,1561,0.055,28569,POINT (-87.761826 41.993931),60646-20210218
60646,02/19/2021,204,6459,100,4794,0.168,104,1665,0.058,28569,POINT (-87.761826 41.993931),60646-20210219
60646,02/20/2021,234,6693,62,4856,0.17,172,1837,0.064,28569,POINT (-87.761826 41.993931),60646-20210220
60646,02/21/2021,67,6760,31,4887,0.171,36,1873,0.066,28569,POINT (-87.761826 41.993931),60646-20210221
60646,02/22/2021,147,6907,52,4939,0.173,95,1968,0.069,28569,POINT (-87.761826 41.993931),60646-20210222
60646,02/23/2021,229,7136,107,5046,0.177,122,2090,0.073,28569,POINT (-87.761826 41.993931),60646-20210223
60646,02/24/2021,218,7354,93,5139,0.18,125,2215,0.078,28569,POINT (-87.761826 41.993931),60646-20210224
60646,02/25/2021,273,7627,108,5247,0.184,165,2380,0.083,28569,POINT (-87.761826 41.993931),60646-20210225
60646,02/26/2021,329,7956,163,5410,0.189,166,2546,0.089,28569,POINT (-87.761826 41.993931),60646-20210226
60646,02/27/2021,200,8156,101,5511,0.193,99,2645,0.093,28569,POINT (-87.761826 41.993931),60646-20210227
60646,02/28/2021,69,8225,34,5545,0.194,35,2680,0.094,28569,POINT (-87.761826 41.993931),60646-20210228
60646,03/01/2021,179,8404,82,5627,0.197,97,2777,0.097,28569,POINT (-87.761826 41.993931),60646-20210301
60646,03/02/2021,225,8629,108,5735,0.201,117,2894,0.101,28569,POINT (-87.761826 41.993931),60646-20210302
60649,02/09/2021,163,3842,91,3049,0.065,72,793,0.017,46633,POINT (-87.571522 41.762202),60649-20210209
60649,02/10/2021,286,4128,155,3204,0.069,131,924,0.02,46633,POINT (-87.571522 41.762202),60649-20210210
60649,02/11/2021,257,4385,136,3340,0.072,121,1045,0.022,46633,POINT (-87.571522 41.762202),60649-20210211
60649,02/12/2021,195,4580,88,3428,0.074,107,1152,0.025,46633,POINT (-87.571522 41.762202),60649-20210212
60649,02/13/2021,126,4706,82,3510,0.075,44,1196,0.026,46633,POINT (-87.571522 41.762202),60649-20210213
60649,02/14/2021,26,4732,24,3534,0.076,2,1198,0.026,46633,POINT (-87.571522 41.762202),60649-20210214
60645,02/01/2021,238,4238,111,3320,0.07,127,918,0.019,47270,POINT (-87.695049 42.008927),60645-20210201
60645,02/02/2021,218,4456,136,3456,0.073,82,1000,0.021,47270,POINT (-87.695049 42.008927),60645-20210202
60645,02/03/2021,236,4692,179,3635,0.077,57,1057,0.022,47270,POINT (-87.695049 42.008927),60645-20210203
60645,02/04/2021,350,5042,307,3942,0.083,43,1100,0.023,47270,POINT (-87.695049 42.008927),60645-20210204
60645,02/05/2021,270,5312,203,4145,0.088,67,1167,0.025,47270,POINT (-87.695049 42.008927),60645-20210205
60645,02/06/2021,108,5420,92,4237,0.09,16,1183,0.025,47270,POINT (-87.695049 42.008927),60645-20210206
60645,02/07/2021,106,5526,97,4334,0.092,9,1192,0.025,47270,POINT (-87.695049 42.008927),60645-20210207
60645,02/08/2021,149,5675,118,4452,0.094,31,1223,0.026,47270,POINT (-87.695049 42.008927),60645-20210208
60645,02/09/2021,245,5920,204,4656,0.098,41,1264,0.027,47270,POINT (-87.695049 42.008927),60645-20210209
60645,02/10/2021,285,6205,189,4845,0.102,96,1360,0.029,47270,POINT (-87.695049 42.008927),60645-20210210
60649,02/15/2021,129,4861,70,3604,0.077,59,1257,0.027,46633,POINT (-87.571522 41.762202),60649-20210215
60649,02/16/2021,199,5060,55,3659,0.078,144,1401,0.03,46633,POINT (-87.571522 41.762202),60649-20210216
60649,02/17/2021,167,5227,77,3736,0.08,90,1491,0.032,46633,POINT (-87.571522 41.762202),60649-20210217
60649,02/18/2021,195,5422,87,3823,0.082,108,1599,0.034,46633,POINT (-87.571522 41.762202),60649-20210218
60649,02/19/2021,227,5649,90,3913,0.084,137,1736,0.037,46633,POINT (-87.571522 41.762202),60649-20210219
60649,02/20/2021,70,5719,27,3940,0.084,43,1779,0.038,46633,POINT (-87.571522 41.762202),60649-20210220
60649,02/21/2021,23,5742,10,3950,0.085,13,1792,0.038,46633,POINT (-87.571522 41.762202),60649-20210221
60649,02/22/2021,155,5897,68,4018,0.086,87,1879,0.04,46633,POINT (-87.571522 41.762202),60649-20210222
60649,02/23/2021,168,6065,73,4091,0.088,95,1974,0.042,46633,POINT (-87.571522 41.762202),60649-20210223
60649,02/24/2021,149,6214,71,4162,0.089,78,2052,0.044,46633,POINT (-87.571522 41.762202),60649-20210224
60649,02/25/2021,209,6423,77,4239,0.091,132,2184,0.047,46633,POINT (-87.571522 41.762202),60649-20210225
60649,02/26/2021,186,6609,83,4322,0.093,103,2287,0.049,46633,POINT (-87.571522 41.762202),60649-20210226
60649,02/27/2021,141,6750,101,4423,0.095,40,2327,0.05,46633,POINT (-87.571522 41.762202),60649-20210227
60649,02/28/2021,34,6784,24,4447,0.095,10,2337,0.05,46633,POINT (-87.571522 41.762202),60649-20210228
60649,03/01/2021,143,6927,77,4524,0.097,66,2403,0.052,46633,POINT (-87.571522 41.762202),60649-20210301
60649,03/02/2021,133,7060,71,4595,0.099,62,2465,0.053,46633,POINT (-87.571522 41.762202),60649-20210302
60649,03/03/2021,222,7282,111,4706,0.101,111,2576,0.055,46633,POINT (-87.571522 41.762202),60649-20210303
60649,03/04/2021,198,7480,122,4828,0.104,76,2652,0.057,46633,POINT (-87.571522 41.762202),60649-20210304
60649,03/05/2021,213,7693,137,4965,0.106,76,2728,0.058,46633,POINT (-87.571522 41.762202),60649-20210305
60651,02/16/2021,82,4706,52,3835,0.06,30,871,0.014,63492,POINT (-87.741017 41.901964),60651-20210216
60651,02/17/2021,168,4874,97,3932,0.062,71,942,0.015,63492,POINT (-87.741017 41.901964),60651-20210217
60645,02/18/2021,361,8162,238,6181,0.131,123,1981,0.042,47270,POINT (-87.695049 42.008927),60645-20210218
60645,02/19/2021,227,8389,121,6302,0.133,106,2087,0.044,47270,POINT (-87.695049 42.008927),60645-20210219
60645,02/20/2021,114,8503,73,6375,0.135,41,2128,0.045,47270,POINT (-87.695049 42.008927),60645-20210220
60645,02/21/2021,124,8627,102,6477,0.137,22,2150,0.045,47270,POINT (-87.695049 42.008927),60645-20210221
60645,02/22/2021,352,8979,94,6571,0.139,258,2408,0.051,47270,POINT (-87.695049 42.008927),60645-20210222
60645,02/23/2021,291,9270,177,6748,0.143,114,2522,0.053,47270,POINT (-87.695049 42.008927),60645-20210223
60651,02/18/2021,191,5065,102,4034,0.064,89,1031,0.016,63492,POINT (-87.741017 41.901964),60651-20210218
60651,02/19/2021,218,5283,121,4155,0.065,97,1128,0.018,63492,POINT (-87.741017 41.901964),60651-20210219
60651,02/20/2021,117,5400,69,4224,0.067,48,1176,0.019,63492,POINT (-87.741017 41.901964),60651-20210220
60645,02/11/2021,338,6543,199,5044,0.107,139,1499,0.032,47270,POINT (-87.695049 42.008927),60645-20210211
60645,02/12/2021,311,6854,225,5269,0.111,86,1585,0.034,47270,POINT (-87.695049 42.008927),60645-20210212
60645,02/13/2021,202,7056,147,5416,0.115,55,1640,0.035,47270,POINT (-87.695049 42.008927),60645-20210213
60645,02/14/2021,99,7155,83,5499,0.116,16,1656,0.035,47270,POINT (-87.695049 42.008927),60645-20210214
60645,02/15/2021,170,7325,128,5627,0.119,42,1698,0.036,47270,POINT (-87.695049 42.008927),60645-20210215
60645,02/16/2021,210,7535,170,5797,0.123,40,1738,0.037,47270,POINT (-87.695049 42.008927),60645-20210216
60645,02/17/2021,266,7801,146,5943,0.126,120,1858,0.039,47270,POINT (-87.695049 42.008927),60645-20210217
60646,02/01/2021,119,2967,89,2390,0.084,30,577,0.02,28569,POINT (-87.761826 41.993931),60646-20210201
60646,02/02/2021,185,3152,131,2521,0.088,54,631,0.022,28569,POINT (-87.761826 41.993931),60646-20210202
60646,02/03/2021,197,3349,156,2677,0.094,41,672,0.024,28569,POINT (-87.761826 41.993931),60646-20210203
60646,02/04/2021,219,3568,178,2855,0.1,41,713,0.025,28569,POINT (-87.761826 41.993931),60646-20210204
60646,02/05/2021,250,3818,205,3060,0.107,45,758,0.027,28569,POINT (-87.761826 41.993931),60646-20210205
60646,02/06/2021,123,3941,100,3160,0.111,23,781,0.027,28569,POINT (-87.761826 41.993931),60646-20210206
60646,02/07/2021,49,3990,42,3202,0.112,7,788,0.028,28569,POINT (-87.761826 41.993931),60646-20210207
60646,02/08/2021,141,4131,112,3314,0.116,29,817,0.029,28569,POINT (-87.761826 41.993931),60646-20210208
60646,02/09/2021,181,4312,143,3457,0.121,38,855,0.03,28569,POINT (-87.761826 41.993931),60646-20210209
60646,02/10/2021,435,4747,285,3742,0.131,150,1005,0.035,28569,POINT (-87.761826 41.993931),60646-20210210
60652,02/06/2021,115,2981,106,2381,0.055,9,600,0.014,43447,POINT (-87.714238 41.745398),60652-20210206
60652,02/07/2021,30,3011,28,2409,0.055,2,602,0.014,43447,POINT (-87.714238 41.745398),60652-20210207
60652,02/08/2021,137,3148,118,2527,0.058,19,621,0.014,43447,POINT (-87.714238 41.745398),60652-20210208
60652,02/09/2021,164,3312,133,2660,0.061,31,652,0.015,43447,POINT (-87.714238 41.745398),60652-20210209
60652,02/10/2021,194,3506,156,2816,0.065,38,690,0.016,43447,POINT (-87.714238 41.745398),60652-20210210
60652,02/11/2021,213,3719,164,2980,0.069,49,739,0.017,43447,POINT (-87.714238 41.745398),60652-20210211
60652,02/12/2021,174,3893,135,3115,0.072,39,778,0.018,43447,POINT (-87.714238 41.745398),60652-20210212
60652,02/13/2021,144,4037,108,3223,0.074,36,814,0.019,43447,POINT (-87.714238 41.745398),60652-20210213
60652,02/14/2021,44,4081,36,3259,0.075,8,822,0.019,43447,POINT (-87.714238 41.745398),60652-20210214
60652,02/15/2021,129,4210,119,3378,0.078,10,832,0.019,43447,POINT (-87.714238 41.745398),60652-20210215
60652,02/16/2021,88,4298,71,3449,0.079,17,849,0.02,43447,POINT (-87.714238 41.745398),60652-20210216
60652,02/17/2021,185,4483,111,3560,0.082,74,923,0.021,43447,POINT (-87.714238 41.745398),60652-20210217
60652,02/18/2021,201,4684,122,3682,0.085,79,1002,0.023,43447,POINT (-87.714238 41.745398),60652-20210218
60652,02/19/2021,189,4873,122,3804,0.088,67,1069,0.025,43447,POINT (-87.714238 41.745398),60652-20210219
60652,02/20/2021,113,4986,60,3864,0.089,53,1122,0.026,43447,POINT (-87.714238 41.745398),60652-20210220
60652,02/21/2021,45,5031,36,3900,0.09,9,1131,0.026,43447,POINT (-87.714238 41.745398),60652-20210221
60652,02/22/2021,165,5196,86,3986,0.092,79,1210,0.028,43447,POINT (-87.714238 41.745398),60652-20210222
60652,02/23/2021,237,5433,131,4117,0.095,106,1316,0.03,43447,POINT (-87.714238 41.745398),60652-20210223
60652,02/24/2021,233,5666,110,4227,0.097,123,1439,0.033,43447,POINT (-87.714238 41.745398),60652-20210224
60652,02/25/2021,284,5950,150,4377,0.101,134,1573,0.036,43447,POINT (-87.714238 41.745398),60652-20210225
60652,02/26/2021,329,6279,183,4560,0.105,146,1719,0.04,43447,POINT (-87.714238 41.745398),60652-20210226
60653,02/16/2021,116,4121,84,3109,0.094,32,1012,0.031,33154,POINT (-87.611244 41.819261),60653-20210216
60653,02/17/2021,132,4253,57,3166,0.095,75,1087,0.033,33154,POINT (-87.611244 41.819261),60653-20210217
60653,02/18/2021,131,4384,56,3222,0.097,75,1162,0.035,33154,POINT (-87.611244 41.819261),60653-20210218
60653,02/19/2021,187,4571,62,3284,0.099,125,1287,0.039,33154,POINT (-87.611244 41.819261),60653-20210219
60653,02/20/2021,42,4613,15,3299,0.1,27,1314,0.04,33154,POINT (-87.611244 41.819261),60653-20210220
60653,02/21/2021,24,4637,7,3306,0.1,17,1331,0.04,33154,POINT (-87.611244 41.819261),60653-20210221
60653,02/22/2021,109,4746,49,3355,0.101,60,1391,0.042,33154,POINT (-87.611244 41.819261),60653-20210222
60653,02/23/2021,135,4881,58,3413,0.103,77,1468,0.044,33154,POINT (-87.611244 41.819261),60653-20210223
60653,02/24/2021,131,5012,67,3480,0.105,64,1532,0.046,33154,POINT (-87.611244 41.819261),60653-20210224
60653,02/25/2021,157,5169,71,3551,0.107,86,1618,0.049,33154,POINT (-87.611244 41.819261),60653-20210225
60653,02/26/2021,192,5361,76,3627,0.109,116,1734,0.052,33154,POINT (-87.611244 41.819261),60653-20210226
60653,02/27/2021,287,5648,238,3865,0.117,49,1783,0.054,33154,POINT (-87.611244 41.819261),60653-20210227
60653,02/28/2021,50,5698,37,3902,0.118,13,1796,0.054,33154,POINT (-87.611244 41.819261),60653-20210228
60653,03/01/2021,130,5828,72,3974,0.12,58,1854,0.056,33154,POINT (-87.611244 41.819261),60653-20210301
60654,02/12/2021,157,3757,84,2601,0.13,73,1156,0.058,20022,POINT (-87.636354 41.892485),60654-20210212
60654,02/13/2021,77,3834,45,2646,0.132,32,1188,0.059,20022,POINT (-87.636354 41.892485),60654-20210213
60654,02/14/2021,32,3866,26,2672,0.133,6,1194,0.06,20022,POINT (-87.636354 41.892485),60654-20210214
60654,02/15/2021,42,3908,27,2699,0.135,15,1209,0.06,20022,POINT (-87.636354 41.892485),60654-20210215
60654,02/16/2021,104,4012,88,2787,0.139,16,1225,0.061,20022,POINT (-87.636354 41.892485),60654-20210216
60654,02/17/2021,101,4113,51,2838,0.142,50,1275,0.064,20022,POINT (-87.636354 41.892485),60654-20210217
60654,02/18/2021,110,4223,42,2880,0.144,68,1343,0.067,20022,POINT (-87.636354 41.892485),60654-20210218
60654,02/19/2021,105,4328,39,2919,0.146,66,1409,0.07,20022,POINT (-87.636354 41.892485),60654-20210219
60654,02/20/2021,67,4395,17,2936,0.147,50,1459,0.073,20022,POINT (-87.636354 41.892485),60654-20210220
60654,02/21/2021,24,4419,5,2941,0.147,19,1478,0.074,20022,POINT (-87.636354 41.892485),60654-20210221
60654,02/22/2021,75,4494,19,2960,0.148,56,1534,0.077,20022,POINT (-87.636354 41.892485),60654-20210222
60654,02/23/2021,111,4605,62,3022,0.151,49,1583,0.079,20022,POINT (-87.636354 41.892485),60654-20210223
60654,02/24/2021,93,4698,41,3063,0.153,52,1635,0.082,20022,POINT (-87.636354 41.892485),60654-20210224
60654,02/25/2021,105,4803,31,3094,0.155,74,1709,0.085,20022,POINT (-87.636354 41.892485),60654-20210225
60654,02/26/2021,168,4971,73,3167,0.158,95,1804,0.09,20022,POINT (-87.636354 41.892485),60654-20210226
60654,02/27/2021,93,5064,49,3216,0.161,44,1848,0.092,20022,POINT (-87.636354 41.892485),60654-20210227
60654,02/28/2021,51,5115,27,3243,0.162,24,1872,0.093,20022,POINT (-87.636354 41.892485),60654-20210228
60654,03/01/2021,99,5214,54,3297,0.165,45,1917,0.096,20022,POINT (-87.636354 41.892485),60654-20210301
60654,03/02/2021,118,5332,62,3359,0.168,56,1973,0.099,20022,POINT (-87.636354 41.892485),60654-20210302
60654,03/03/2021,134,5466,66,3425,0.171,68,2041,0.102,20022,POINT (-87.636354 41.892485),60654-20210303
60655,02/13/2021,142,5750,104,4364,0.153,38,1386,0.049,28569,POINT (-87.701434 41.696456),60655-20210213
60655,02/14/2021,48,5798,21,4385,0.153,27,1413,0.049,28569,POINT (-87.701434 41.696456),60655-20210214
60655,02/15/2021,112,5910,62,4447,0.156,50,1463,0.051,28569,POINT (-87.701434 41.696456),60655-20210215
60655,02/16/2021,118,6028,73,4520,0.158,45,1508,0.053,28569,POINT (-87.701434 41.696456),60655-20210216
60655,02/17/2021,271,6299,89,4609,0.161,182,1690,0.059,28569,POINT (-87.701434 41.696456),60655-20210217
60655,02/18/2021,298,6597,99,4708,0.165,199,1889,0.066,28569,POINT (-87.701434 41.696456),60655-20210218
60655,02/19/2021,242,6839,108,4816,0.169,134,2023,0.071,28569,POINT (-87.701434 41.696456),60655-20210219
60655,02/20/2021,189,7028,55,4871,0.17,134,2157,0.076,28569,POINT (-87.701434 41.696456),60655-20210220
60655,02/21/2021,44,7072,16,4887,0.171,28,2185,0.076,28569,POINT (-87.701434 41.696456),60655-20210221
60655,02/22/2021,210,7282,72,4959,0.174,138,2323,0.081,28569,POINT (-87.701434 41.696456),60655-20210222
60655,02/23/2021,234,7516,61,5020,0.176,173,2496,0.087,28569,POINT (-87.701434 41.696456),60655-20210223
60655,02/24/2021,245,7761,66,5086,0.178,179,2675,0.094,28569,POINT (-87.701434 41.696456),60655-20210224
60655,02/25/2021,276,8037,68,5154,0.18,208,2883,0.101,28569,POINT (-87.701434 41.696456),60655-20210225
60655,02/26/2021,278,8315,96,5250,0.184,182,3065,0.107,28569,POINT (-87.701434 41.696456),60655-20210226
60656,02/05/2021,144,2185,125,1732,0.061,19,453,0.016,28218,POINT (-87.817934 41.974566),60656-20210205
60656,02/06/2021,104,2289,94,1826,0.065,10,463,0.016,28218,POINT (-87.817934 41.974566),60656-20210206
60656,02/07/2021,30,2319,28,1854,0.066,2,465,0.016,28218,POINT (-87.817934 41.974566),60656-20210207
60656,02/08/2021,103,2422,75,1929,0.068,28,493,0.017,28218,POINT (-87.817934 41.974566),60656-20210208
60652,02/02/2021,130,2263,97,1753,0.04,33,510,0.012,43447,POINT (-87.714238 41.745398),60652-20210202
60652,02/03/2021,213,2476,171,1924,0.044,42,552,0.013,43447,POINT (-87.714238 41.745398),60652-20210203
60652,02/04/2021,188,2664,159,2083,0.048,29,581,0.013,43447,POINT (-87.714238 41.745398),60652-20210204
60656,02/09/2021,166,2588,137,2066,0.073,29,522,0.018,28218,POINT (-87.817934 41.974566),60656-20210209
60656,02/10/2021,154,2742,128,2194,0.078,26,548,0.019,28218,POINT (-87.817934 41.974566),60656-20210210
60656,02/11/2021,179,2921,140,2334,0.083,39,587,0.021,28218,POINT (-87.817934 41.974566),60656-20210211
60656,02/12/2021,165,3086,137,2471,0.088,28,615,0.022,28218,POINT (-87.817934 41.974566),60656-20210212
60656,02/13/2021,129,3215,96,2567,0.091,33,648,0.023,28218,POINT (-87.817934 41.974566),60656-20210213
60656,02/14/2021,40,3255,35,2602,0.092,5,653,0.023,28218,POINT (-87.817934 41.974566),60656-20210214
60656,02/15/2021,89,3344,72,2674,0.095,17,670,0.024,28218,POINT (-87.817934 41.974566),60656-20210215
60656,02/16/2021,96,3440,72,2746,0.097,24,694,0.025,28218,POINT (-87.817934 41.974566),60656-20210216
60656,02/17/2021,162,3602,95,2841,0.101,67,761,0.027,28218,POINT (-87.817934 41.974566),60656-20210217
60656,02/18/2021,172,3774,91,2932,0.104,81,842,0.03,28218,POINT (-87.817934 41.974566),60656-20210218
60656,02/19/2021,158,3932,75,3007,0.107,83,925,0.033,28218,POINT (-87.817934 41.974566),60656-20210219
60659,01/06/2021,68,659,59,649,0.015,9,10,0,42735,POINT (-87.703266 41.990803),60659-20210106
60659,01/07/2021,99,758,61,710,0.017,38,48,0.001,42735,POINT (-87.703266 41.990803),60659-20210107
60659,01/08/2021,72,830,42,752,0.018,30,78,0.002,42735,POINT (-87.703266 41.990803),60659-20210108
60659,01/09/2021,38,868,15,767,0.018,23,101,0.002,42735,POINT (-87.703266 41.990803),60659-20210109
60659,01/10/2021,11,879,3,770,0.018,8,109,0.003,42735,POINT (-87.703266 41.990803),60659-20210110
60654,02/03/2021,78,2790,53,1914,0.096,25,876,0.044,20022,POINT (-87.636354 41.892485),60654-20210203
60659,01/11/2021,67,946,23,793,0.019,44,153,0.004,42735,POINT (-87.703266 41.990803),60659-20210111
60659,01/12/2021,75,1021,46,839,0.02,29,182,0.004,42735,POINT (-87.703266 41.990803),60659-20210112
60659,01/13/2021,100,1121,61,900,0.021,39,221,0.005,42735,POINT (-87.703266 41.990803),60659-20210113
60659,01/14/2021,175,1296,168,1068,0.025,7,228,0.005,42735,POINT (-87.703266 41.990803),60659-20210114
60659,01/15/2021,70,1366,64,1132,0.026,6,234,0.005,42735,POINT (-87.703266 41.990803),60659-20210115
60659,01/16/2021,110,1476,108,1240,0.029,2,236,0.006,42735,POINT (-87.703266 41.990803),60659-20210116
60659,01/17/2021,6,1482,6,1246,0.029,0,236,0.006,42735,POINT (-87.703266 41.990803),60659-20210117
60659,01/18/2021,53,1535,37,1283,0.03,16,252,0.006,42735,POINT (-87.703266 41.990803),60659-20210118
60659,01/19/2021,86,1621,50,1333,0.031,36,288,0.007,42735,POINT (-87.703266 41.990803),60659-20210119
60659,01/20/2021,99,1720,68,1401,0.033,31,319,0.007,42735,POINT (-87.703266 41.990803),60659-20210120
60659,01/21/2021,127,1847,101,1502,0.035,26,345,0.008,42735,POINT (-87.703266 41.990803),60659-20210121
60659,01/22/2021,107,1954,100,1602,0.037,7,352,0.008,42735,POINT (-87.703266 41.990803),60659-20210122
60659,01/23/2021,51,2005,45,1647,0.039,6,358,0.008,42735,POINT (-87.703266 41.990803),60659-20210123
60659,01/24/2021,19,2024,14,1661,0.039,5,363,0.008,42735,POINT (-87.703266 41.990803),60659-20210124
60659,01/25/2021,92,2116,59,1720,0.04,33,396,0.009,42735,POINT (-87.703266 41.990803),60659-20210125
60659,01/26/2021,115,2231,70,1790,0.042,45,441,0.01,42735,POINT (-87.703266 41.990803),60659-20210126
60659,01/27/2021,167,2398,106,1896,0.044,61,502,0.012,42735,POINT (-87.703266 41.990803),60659-20210127
60659,01/28/2021,119,2517,102,1998,0.047,17,519,0.012,42735,POINT (-87.703266 41.990803),60659-20210128
60659,01/29/2021,118,2635,102,2100,0.049,16,535,0.013,42735,POINT (-87.703266 41.990803),60659-20210129
60659,01/30/2021,91,2726,82,2182,0.051,9,544,0.013,42735,POINT (-87.703266 41.990803),60659-20210130
60659,01/31/2021,45,2771,27,2209,0.052,18,562,0.013,42735,POINT (-87.703266 41.990803),60659-20210131
60659,02/01/2021,105,2876,72,2281,0.053,33,595,0.014,42735,POINT (-87.703266 41.990803),60659-20210201
60659,02/02/2021,132,3008,96,2377,0.056,36,631,0.015,42735,POINT (-87.703266 41.990803),60659-20210202
60659,02/03/2021,149,3157,113,2490,0.058,36,667,0.016,42735,POINT (-87.703266 41.990803),60659-20210203
60659,02/04/2021,248,3405,202,2692,0.063,46,713,0.017,42735,POINT (-87.703266 41.990803),60659-20210204
60659,02/05/2021,220,3625,156,2848,0.067,64,777,0.018,42735,POINT (-87.703266 41.990803),60659-20210205
60659,02/06/2021,95,3720,84,2932,0.069,11,788,0.018,42735,POINT (-87.703266 41.990803),60659-20210206
60659,02/07/2021,59,3779,57,2989,0.07,2,790,0.018,42735,POINT (-87.703266 41.990803),60659-20210207
60655,01/15/2021,49,1460,41,1084,0.038,8,376,0.013,28569,POINT (-87.701434 41.696456),60655-20210115
60655,01/16/2021,22,1482,16,1100,0.039,6,382,0.013,28569,POINT (-87.701434 41.696456),60655-20210116
60655,01/17/2021,13,1495,13,1113,0.039,0,382,0.013,28569,POINT (-87.701434 41.696456),60655-20210117
60655,01/18/2021,44,1539,41,1154,0.04,3,385,0.013,28569,POINT (-87.701434 41.696456),60655-20210118
60655,01/19/2021,57,1596,47,1201,0.042,10,395,0.014,28569,POINT (-87.701434 41.696456),60655-20210119
60655,01/20/2021,84,1680,61,1262,0.044,23,418,0.015,28569,POINT (-87.701434 41.696456),60655-20210120
60655,01/21/2021,116,1796,102,1364,0.048,14,432,0.015,28569,POINT (-87.701434 41.696456),60655-20210121
60655,01/22/2021,159,1955,150,1514,0.053,9,441,0.015,28569,POINT (-87.701434 41.696456),60655-20210122
60655,01/23/2021,85,2040,76,1590,0.056,9,450,0.016,28569,POINT (-87.701434 41.696456),60655-20210123
60655,01/24/2021,36,2076,35,1625,0.057,1,451,0.016,28569,POINT (-87.701434 41.696456),60655-20210124
60655,01/25/2021,123,2199,97,1722,0.06,26,477,0.017,28569,POINT (-87.701434 41.696456),60655-20210125
60655,01/26/2021,144,2343,111,1833,0.064,33,510,0.018,28569,POINT (-87.701434 41.696456),60655-20210126
60655,01/27/2021,234,2577,208,2041,0.071,26,536,0.019,28569,POINT (-87.701434 41.696456),60655-20210127
60655,01/28/2021,232,2809,195,2236,0.078,37,573,0.02,28569,POINT (-87.701434 41.696456),60655-20210128
60655,01/29/2021,177,2986,148,2384,0.083,29,602,0.021,28569,POINT (-87.701434 41.696456),60655-20210129
60655,01/30/2021,238,3224,124,2508,0.088,114,716,0.025,28569,POINT (-87.701434 41.696456),60655-20210130
60655,01/31/2021,27,3251,25,2533,0.089,2,718,0.025,28569,POINT (-87.701434 41.696456),60655-20210131
60655,02/01/2021,128,3379,87,2620,0.092,41,759,0.027,28569,POINT (-87.701434 41.696456),60655-20210201
60655,02/02/2021,214,3593,149,2769,0.097,65,824,0.029,28569,POINT (-87.701434 41.696456),60655-20210202
60655,02/03/2021,193,3786,168,2937,0.103,25,849,0.03,28569,POINT (-87.701434 41.696456),60655-20210203
60655,02/04/2021,228,4014,203,3140,0.11,25,874,0.031,28569,POINT (-87.701434 41.696456),60655-20210204
60655,02/05/2021,203,4217,178,3318,0.116,25,899,0.031,28569,POINT (-87.701434 41.696456),60655-20210205
60655,02/06/2021,111,4328,95,3413,0.119,16,915,0.032,28569,POINT (-87.701434 41.696456),60655-20210206
60655,02/07/2021,36,4364,32,3445,0.121,4,919,0.032,28569,POINT (-87.701434 41.696456),60655-20210207
60655,02/08/2021,149,4513,107,3552,0.124,42,961,0.034,28569,POINT (-87.701434 41.696456),60655-20210208
60659,02/18/2021,207,5884,142,4345,0.102,65,1539,0.036,42735,POINT (-87.703266 41.990803),60659-20210218
60659,02/19/2021,143,6027,70,4415,0.103,73,1612,0.038,42735,POINT (-87.703266 41.990803),60659-20210219
60659,02/20/2021,76,6103,28,4443,0.104,48,1660,0.039,42735,POINT (-87.703266 41.990803),60659-20210220
60659,02/21/2021,45,6148,24,4467,0.105,21,1681,0.039,42735,POINT (-87.703266 41.990803),60659-20210221
60655,02/09/2021,218,4731,156,3708,0.13,62,1023,0.036,28569,POINT (-87.701434 41.696456),60655-20210209
60655,02/10/2021,295,5026,168,3876,0.136,127,1150,0.04,28569,POINT (-87.701434 41.696456),60655-20210210
60655,02/11/2021,319,5345,206,4082,0.143,113,1263,0.044,28569,POINT (-87.701434 41.696456),60655-20210211
60655,02/12/2021,263,5608,178,4260,0.149,85,1348,0.047,28569,POINT (-87.701434 41.696456),60655-20210212
60659,02/08/2021,134,3913,107,3096,0.072,27,817,0.019,42735,POINT (-87.703266 41.990803),60659-20210208
60659,02/09/2021,160,4073,119,3215,0.075,41,858,0.02,42735,POINT (-87.703266 41.990803),60659-20210209
60659,02/10/2021,256,4329,177,3392,0.079,79,937,0.022,42735,POINT (-87.703266 41.990803),60659-20210210
60659,02/11/2021,397,4726,193,3585,0.084,204,1141,0.027,42735,POINT (-87.703266 41.990803),60659-20210211
60659,02/12/2021,272,4998,178,3763,0.088,94,1235,0.029,42735,POINT (-87.703266 41.990803),60659-20210212
60659,02/13/2021,212,5210,96,3859,0.09,116,1351,0.032,42735,POINT (-87.703266 41.990803),60659-20210213
60659,02/14/2021,46,5256,37,3896,0.091,9,1360,0.032,42735,POINT (-87.703266 41.990803),60659-20210214
60659,02/15/2021,140,5396,118,4014,0.094,22,1382,0.032,42735,POINT (-87.703266 41.990803),60659-20210215
60659,02/16/2021,87,5483,65,4079,0.095,22,1404,0.033,42735,POINT (-87.703266 41.990803),60659-20210216
60659,02/17/2021,194,5677,124,4203,0.098,70,1474,0.034,42735,POINT (-87.703266 41.990803),60659-20210217
60656,02/01/2021,74,1681,57,1321,0.047,17,360,0.013,28218,POINT (-87.817934 41.974566),60656-20210201
60656,02/02/2021,92,1773,72,1393,0.049,20,380,0.013,28218,POINT (-87.817934 41.974566),60656-20210202
60656,02/03/2021,126,1899,98,1491,0.053,28,408,0.014,28218,POINT (-87.817934 41.974566),60656-20210203
60659,02/23/2021,201,6468,127,4645,0.109,74,1823,0.043,42735,POINT (-87.703266 41.990803),60659-20210223
60656,02/04/2021,142,2041,116,1607,0.057,26,434,0.015,28218,POINT (-87.817934 41.974566),60656-20210204
60660,02/06/2021,137,6040,96,4424,0.099,41,1616,0.036,44498,POINT (-87.666362 41.991062),60660-20210206
60660,02/07/2021,49,6089,39,4463,0.1,10,1626,0.037,44498,POINT (-87.666362 41.991062),60660-20210207
60660,02/08/2021,159,6248,118,4581,0.103,41,1667,0.037,44498,POINT (-87.666362 41.991062),60660-20210208
60660,02/09/2021,180,6428,136,4717,0.106,44,1711,0.038,44498,POINT (-87.666362 41.991062),60660-20210209
60660,02/10/2021,359,6787,260,4977,0.112,99,1810,0.041,44498,POINT (-87.666362 41.991062),60660-20210210
60660,02/11/2021,299,7086,168,5145,0.116,131,1941,0.044,44498,POINT (-87.666362 41.991062),60660-20210211
60660,02/12/2021,339,7425,237,5382,0.121,102,2043,0.046,44498,POINT (-87.666362 41.991062),60660-20210212
60660,02/13/2021,220,7645,161,5543,0.125,59,2102,0.047,44498,POINT (-87.666362 41.991062),60660-20210213
60660,02/14/2021,57,7702,34,5577,0.125,23,2125,0.048,44498,POINT (-87.666362 41.991062),60660-20210214
60660,02/15/2021,146,7848,114,5691,0.128,32,2157,0.048,44498,POINT (-87.666362 41.991062),60660-20210215
60660,02/16/2021,154,8002,127,5818,0.131,27,2184,0.049,44498,POINT (-87.666362 41.991062),60660-20210216
60660,02/17/2021,228,8230,128,5946,0.134,100,2284,0.051,44498,POINT (-87.666362 41.991062),60660-20210217
60660,02/18/2021,276,8506,140,6086,0.137,136,2420,0.054,44498,POINT (-87.666362 41.991062),60660-20210218
60661,02/26/2021,88,2683,34,1651,0.159,54,1032,0.1,10354,POINT (-87.644283 41.882786),60661-20210226
60661,02/27/2021,26,2709,15,1666,0.161,11,1043,0.101,10354,POINT (-87.644283 41.882786),60661-20210227
60707,02/17/2021,63,1872,30,1466,0.034,33,406,0.009,43093,POINT (-87.808283 41.921777),60707-20210217
60707,02/18/2021,63,1935,27,1493,0.035,36,442,0.01,43093,POINT (-87.808283 41.921777),60707-20210218
60707,02/21/2021,10,2073,8,1568,0.036,2,505,0.012,43093,POINT (-87.808283 41.921777),60707-20210221
60707,02/22/2021,51,2124,23,1591,0.037,28,533,0.012,43093,POINT (-87.808283 41.921777),60707-20210222
60707,02/23/2021,89,2213,50,1641,0.038,39,572,0.013,43093,POINT (-87.808283 41.921777),60707-20210223
60707,02/24/2021,64,2277,30,1671,0.039,34,606,0.014,43093,POINT (-87.808283 41.921777),60707-20210224
60707,02/26/2021,89,2439,44,1747,0.041,45,692,0.016,43093,POINT (-87.808283 41.921777),60707-20210226
60707,02/27/2021,105,2544,78,1825,0.042,27,719,0.017,43093,POINT (-87.808283 41.921777),60707-20210227
60707,02/28/2021,27,2571,19,1844,0.043,8,727,0.017,43093,POINT (-87.808283 41.921777),60707-20210228
60707,03/01/2021,45,2616,21,1865,0.043,24,751,0.017,43093,POINT (-87.808283 41.921777),60707-20210301
60707,03/02/2021,82,2698,41,1906,0.044,41,792,0.018,43093,POINT (-87.808283 41.921777),60707-20210302
60707,03/03/2021,211,2909,153,2059,0.048,58,850,0.02,43093,POINT (-87.808283 41.921777),60707-20210303
60707,03/04/2021,92,3001,32,2091,0.049,60,910,0.021,43093,POINT (-87.808283 41.921777),60707-20210304
60707,03/05/2021,97,3098,62,2153,0.05,35,945,0.022,43093,POINT (-87.808283 41.921777),60707-20210305
60827,03/03/2021,11,267,4,184,0.006,7,83,0.003,28483,POINT (-87.633087 41.650765),60827-20210303
60827,03/05/2021,7,281,5,193,0.007,2,88,0.003,28483,POINT (-87.633087 41.650765),60827-20210305
Unknown,03/03/2021,38,2206,25,1369,0,13,837,0,0,,Unknown-20210303
60666,03/06/2021,1,37,0,24,0,1,13,0,0,POINT (-87.896371 41.979511),60666-20210306
60827,03/06/2021,3,284,1,194,0.007,2,90,0.003,28483,POINT (-87.633087 41.650765),60827-20210306
60604,03/06/2021,2,508,2,308,0.374,0,200,0.243,823,POINT (-87.629029 41.878153),60604-20210306
60605,03/06/2021,71,10701,36,6388,0.22,35,4313,0.148,29060,POINT (-87.623449 41.867824),60605-20210306
60616,03/06/2021,181,14190,100,9112,0.168,81,5078,0.094,54197,POINT (-87.629531 41.844869),60616-20210306
60652,03/06/2021,165,7965,103,5521,0.127,62,2444,0.056,43447,POINT (-87.714238 41.745398),60652-20210306
60661,02/01/2021,36,1577,26,1033,0.1,10,544,0.053,10354,POINT (-87.644283 41.882786),60661-20210201
60661,02/02/2021,47,1624,23,1056,0.102,24,568,0.055,10354,POINT (-87.644283 41.882786),60661-20210202
60661,02/03/2021,41,1665,27,1083,0.105,14,582,0.056,10354,POINT (-87.644283 41.882786),60661-20210203
60661,02/04/2021,72,1737,50,1133,0.109,22,604,0.058,10354,POINT (-87.644283 41.882786),60661-20210204
60661,02/05/2021,75,1812,53,1186,0.115,22,626,0.06,10354,POINT (-87.644283 41.882786),60661-20210205
60661,02/06/2021,32,1844,19,1205,0.116,13,639,0.062,10354,POINT (-87.644283 41.882786),60661-20210206
60661,02/07/2021,15,1859,14,1219,0.118,1,640,0.062,10354,POINT (-87.644283 41.882786),60661-20210207
60661,02/08/2021,22,1881,15,1234,0.119,7,647,0.062,10354,POINT (-87.644283 41.882786),60661-20210208
60661,02/09/2021,43,1924,27,1261,0.122,16,663,0.064,10354,POINT (-87.644283 41.882786),60661-20210209
60661,02/10/2021,63,1987,46,1307,0.126,17,680,0.066,10354,POINT (-87.644283 41.882786),60661-20210210
60661,02/11/2021,59,2046,27,1334,0.129,32,712,0.069,10354,POINT (-87.644283 41.882786),60661-20210211
60661,02/12/2021,59,2105,32,1366,0.132,27,739,0.071,10354,POINT (-87.644283 41.882786),60661-20210212
60661,02/13/2021,48,2153,26,1392,0.134,22,761,0.073,10354,POINT (-87.644283 41.882786),60661-20210213
60661,02/14/2021,12,2165,10,1402,0.135,2,763,0.074,10354,POINT (-87.644283 41.882786),60661-20210214
60661,02/15/2021,29,2194,21,1423,0.137,8,771,0.074,10354,POINT (-87.644283 41.882786),60661-20210215
60661,02/16/2021,47,2241,30,1453,0.14,17,788,0.076,10354,POINT (-87.644283 41.882786),60661-20210216
60661,02/17/2021,45,2286,23,1476,0.143,22,810,0.078,10354,POINT (-87.644283 41.882786),60661-20210217
60661,02/18/2021,57,2343,32,1508,0.146,25,835,0.081,10354,POINT (-87.644283 41.882786),60661-20210218
60661,02/19/2021,45,2388,23,1531,0.148,22,857,0.083,10354,POINT (-87.644283 41.882786),60661-20210219
60661,02/20/2021,22,2410,8,1539,0.149,14,871,0.084,10354,POINT (-87.644283 41.882786),60661-20210220
60661,02/21/2021,4,2414,0,1539,0.149,4,875,0.085,10354,POINT (-87.644283 41.882786),60661-20210221
60661,02/22/2021,21,2435,8,1547,0.149,13,888,0.086,10354,POINT (-87.644283 41.882786),60661-20210222
60661,02/23/2021,50,2485,23,1570,0.152,27,915,0.088,10354,POINT (-87.644283 41.882786),60661-20210223
60661,02/24/2021,53,2538,25,1595,0.154,28,943,0.091,10354,POINT (-87.644283 41.882786),60661-20210224
60661,02/25/2021,57,2595,22,1617,0.156,35,978,0.094,10354,POINT (-87.644283 41.882786),60661-20210225
60707,02/19/2021,74,2009,35,1528,0.035,39,481,0.011,43093,POINT (-87.808283 41.921777),60707-20210219
60707,02/20/2021,54,2063,32,1560,0.036,22,503,0.012,43093,POINT (-87.808283 41.921777),60707-20210220
60827,03/02/2021,6,256,4,180,0.006,2,76,0.003,28483,POINT (-87.633087 41.650765),60827-20210302
Unknown,02/27/2021,46,2110,31,1308,0,15,802,0,0,,Unknown-20210227
Unknown,02/28/2021,12,2122,11,1319,0,1,803,0,0,,Unknown-20210228
Unknown,03/01/2021,11,2133,5,1324,0,6,809,0,0,,Unknown-20210301
60666,03/04/2021,0,36,0,24,0,0,12,0,0,POINT (-87.896371 41.979511),60666-20210304
60608,03/04/2021,441,17068,247,11303,0.141,194,5765,0.072,80059,POINT (-87.670366 41.849879),60608-20210304
60601,02/22/2021,43,3353,17,2176,0.144,26,1177,0.078,15083,POINT (-87.622844 41.886262),60601-20210222
60604,03/04/2021,8,499,6,303,0.368,2,196,0.238,823,POINT (-87.629029 41.878153),60604-20210304
60609,03/04/2021,303,9291,165,6415,0.105,138,2876,0.047,60939,POINT (-87.653382 41.812017),60609-20210304
60603,03/04/2021,8,754,5,473,0.45,3,281,0.267,1052,POINT (-87.625473 41.880112),60603-20210304
Unknown,03/04/2021,51,2257,27,1396,0,24,861,0,0,,Unknown-20210304
60609,01/05/2021,37,412,34,409,0.007,3,3,0,60939,POINT (-87.653382 41.812017),60609-20210105
60630,12/30/2020,74,607,74,607,0.011,0,0,0,56433,POINT (-87.759611 41.971261),60630-20201230
60622,01/11/2021,309,3818,96,2856,0.054,213,962,0.018,53294,POINT (-87.681818 41.902762),60622-20210111
60631,01/28/2021,167,2770,141,2237,0.076,26,533,0.018,29529,POINT (-87.813371 41.995019),60631-20210128
60639,12/29/2020,32,281,32,281,0.003,0,0,0,88204,POINT (-87.75531 41.920609),60639-20201229
60656,01/11/2021,41,588,10,433,0.015,31,155,0.005,28218,POINT (-87.817934 41.974566),60656-20210111
60620,01/03/2021,8,271,7,270,0.004,1,1,0,67711,POINT (-87.651656 41.740873),60620-20210103
60633,01/18/2021,10,147,8,120,0.009,2,27,0.002,12689,POINT (-87.556037 41.653147),60633-20210118
60827,01/20/2021,3,42,2,36,0.001,1,6,0,28483,POINT (-87.633087 41.650765),60827-20210120
60707,12/16/2020,1,1,1,1,0,0,0,0,43093,POINT (-87.808283 41.921777),60707-20201216
60625,12/22/2020,67,500,67,500,0.006,0,0,0,79444,POINT (-87.701816 41.971155),60625-20201222
60618,12/26/2020,25,943,25,943,0.01,0,0,0,94907,POINT (-87.703343 41.946699),60618-20201226
60623,12/17/2020,10,12,10,12,0,0,0,0,81283,POINT (-87.717446 41.850321),60623-20201217
60827,03/04/2021,7,274,4,188,0.007,3,86,0.003,28483,POINT (-87.633087 41.650765),60827-20210304
60619,12/22/2020,19,86,19,86,0.001,0,0,0,61207,POINT (-87.60569 41.744737),60619-20201222
60609,12/20/2020,12,72,12,72,0.001,0,0,0,60939,POINT (-87.653382 41.812017),60609-20201220
60605,03/04/2021,206,10410,124,6206,0.214,82,4204,0.145,29060,POINT (-87.623449 41.867824),60605-20210304
60616,03/04/2021,356,13551,189,8734,0.161,167,4817,0.089,54197,POINT (-87.629531 41.844869),60616-20210304
60620,03/04/2021,404,9250,201,6398,0.094,203,2852,0.042,67711,POINT (-87.651656 41.740873),60620-20210304
60614,12/25/2020,1,1284,1,1284,0.018,0,0,0,71954,POINT (-87.652064 41.922605),60614-20201225
60611,01/13/2021,152,4724,71,3144,0.095,81,1580,0.048,33224,POINT (-87.620291 41.894734),60611-20210113
60632,03/04/2021,699,16186,385,12318,0.137,314,3868,0.043,89857,POINT (-87.711251 41.810038),60632-20210304
60638,12/29/2020,73,430,73,430,0.007,0,0,0,58669,POINT (-87.771902 41.787032),60638-20201229
60639,03/04/2021,410,15869,217,12387,0.14,193,3482,0.039,88204,POINT (-87.75531 41.920609),60639-20210304
60652,03/04/2021,238,7499,157,5248,0.121,81,2251,0.052,43447,POINT (-87.714238 41.745398),60652-20210304
60640,12/18/2020,174,218,174,218,0.003,0,0,0,69363,POINT (-87.662232 41.971888),60640-20201218
60624,01/13/2021,31,333,21,284,0.008,10,49,0.001,34892,POINT (-87.722735 41.879417),60624-20210113
60616,01/04/2021,76,1027,67,1016,0.019,9,11,0,54197,POINT (-87.629531 41.844869),60616-20210104
60636,01/22/2021,76,452,72,391,0.013,4,61,0.002,30024,POINT (-87.668597 41.77599),60636-20210122
60631,01/17/2021,43,1613,39,1278,0.043,4,335,0.011,29529,POINT (-87.813371 41.995019),60631-20210117
60656,03/04/2021,192,5712,80,3885,0.138,112,1827,0.065,28218,POINT (-87.817934 41.974566),60656-20210304
60827,01/31/2021,1,84,1,72,0.003,0,12,0,28483,POINT (-87.633087 41.650765),60827-20210131
60642,12/26/2020,10,523,10,523,0.027,0,0,0,19716,POINT (-87.657821 41.899935),60642-20201226
60707,12/19/2020,8,25,8,25,0.001,0,0,0,43093,POINT (-87.808283 41.921777),60707-20201219
60707,01/02/2021,2,122,2,122,0.003,0,0,0,43093,POINT (-87.808283 41.921777),60707-20210102
60632,12/16/2020,3,3,3,3,0,0,0,0,89857,POINT (-87.711251 41.810038),60632-20201216
60602,01/07/2021,2,64,0,61,0.053,2,3,0.003,1145,POINT (-87.628309 41.883136),60602-20210107
60629,01/09/2021,60,933,31,829,0.008,29,104,0.001,110029,POINT (-87.711565 41.777061),60629-20210109
60628,01/28/2021,182,1924,171,1674,0.026,11,250,0.004,64254,POINT (-87.621537 41.694192),60628-20210128
60629,12/18/2020,50,69,50,69,0.001,0,0,0,110029,POINT (-87.711565 41.777061),60629-20201218
60641,01/28/2021,250,3703,212,2911,0.042,38,792,0.011,69880,POINT (-87.746791 41.946682),60641-20210128
60628,12/18/2020,21,28,21,28,0,0,0,0,64254,POINT (-87.621537 41.694192),60628-20201218
60646,01/29/2021,128,2731,114,2197,0.077,14,534,0.019,28569,POINT (-87.761826 41.993931),60646-20210129
60656,01/28/2021,106,1418,91,1100,0.039,15,318,0.011,28218,POINT (-87.817934 41.974566),60656-20210128
60657,12/21/2020,281,1048,281,1048,0.015,0,0,0,70958,POINT (-87.658216 41.939715),60657-20201221
60631,12/16/2020,3,3,3,3,0,0,0,0,29529,POINT (-87.813371 41.995019),60631-20201216
60607,12/26/2020,13,1010,13,1010,0.034,0,0,0,29293,POINT (-87.652727 41.876104),60607-20201226
60605,01/19/2021,120,3745,55,2395,0.082,65,1350,0.046,29060,POINT (-87.623449 41.867824),60605-20210119
60652,12/15/2020,1,1,1,1,0,0,0,0,43447,POINT (-87.714238 41.745398),60652-20201215
60623,12/28/2020,93,252,93,252,0.003,0,0,0,81283,POINT (-87.717446 41.850321),60623-20201228
60647,12/17/2020,87,95,87,95,0.001,0,0,0,87633,POINT (-87.701101 41.921058),60647-20201217
60640,01/19/2021,159,4389,89,3525,0.051,70,864,0.012,69363,POINT (-87.662232 41.971888),60640-20210119
60661,12/15/2020,0,0,0,0,0,0,0,0,10354,POINT (-87.644283 41.882786),60661-20201215
60652,01/16/2021,26,883,19,737,0.017,7,146,0.003,43447,POINT (-87.714238 41.745398),60652-20210116
60605,01/05/2021,107,1815,77,1763,0.061,30,52,0.002,29060,POINT (-87.623449 41.867824),60605-20210105
60609,12/19/2020,19,60,19,60,0.001,0,0,0,60939,POINT (-87.653382 41.812017),60609-20201219
60656,12/16/2020,1,1,1,1,0,0,0,0,28218,POINT (-87.817934 41.974566),60656-20201216
60613,01/10/2021,34,2165,14,1741,0.034,20,424,0.008,50761,POINT (-87.661343 41.953742),60613-20210110
60633,01/29/2021,40,391,39,322,0.025,1,69,0.005,12689,POINT (-87.556037 41.653147),60633-20210129
60646,01/27/2021,141,2428,116,1928,0.067,25,500,0.018,28569,POINT (-87.761826 41.993931),60646-20210127
60624,01/30/2021,28,1039,22,872,0.025,6,167,0.005,34892,POINT (-87.722735 41.879417),60624-20210130
60633,02/15/2021,13,897,9,721,0.057,4,176,0.014,12689,POINT (-87.556037 41.653147),60633-20210215
60636,01/05/2021,12,113,11,112,0.004,1,1,0,30024,POINT (-87.668597 41.77599),60636-20210105
60656,01/21/2021,66,974,54,730,0.026,12,244,0.009,28218,POINT (-87.817934 41.974566),60656-20210121
60647,01/01/2021,0,1345,0,1345,0.015,0,0,0,87633,POINT (-87.701101 41.921058),60647-20210101
60625,01/11/2021,176,2288,57,1864,0.023,119,424,0.005,79444,POINT (-87.701816 41.971155),60625-20210111
60633,12/24/2020,3,26,3,26,0.002,0,0,0,12689,POINT (-87.556037 41.653147),60633-20201224
60607,12/15/2020,1,1,1,1,0,0,0,0,29293,POINT (-87.652727 41.876104),60607-20201215
60613,12/20/2020,17,404,17,404,0.008,0,0,0,50761,POINT (-87.661343 41.953742),60613-20201220
60601,12/15/2020,0,0,0,0,0,0,0,0,15083,POINT (-87.622844 41.886262),60601-20201215
60616,12/24/2020,32,648,32,648,0.012,0,0,0,54197,POINT (-87.629531 41.844869),60616-20201224
60608,12/24/2020,32,564,32,564,0.007,0,0,0,80059,POINT (-87.670366 41.849879),60608-20201224
60609,01/26/2021,115,1844,84,1503,0.025,31,341,0.006,60939,POINT (-87.653382 41.812017),60609-20210126
60624,01/08/2021,21,234,13,214,0.006,8,20,0.001,34892,POINT (-87.722735 41.879417),60624-20210108
60617,01/31/2021,27,3617,24,3130,0.037,3,487,0.006,83553,POINT (-87.556897 41.721257),60617-20210131
60626,12/21/2020,61,231,61,231,0.005,0,0,0,50544,POINT (-87.669834 42.009469),60626-20201221
60626,12/15/2020,0,0,0,0,0,0,0,0,50544,POINT (-87.669834 42.009469),60626-20201215
60602,12/25/2020,0,30,0,30,0.026,0,0,0,1145,POINT (-87.628309 41.883136),60602-20201225
60616,01/25/2021,130,3538,90,2607,0.048,40,931,0.017,54197,POINT (-87.629531 41.844869),60616-20210125
60631,01/02/2021,162,633,162,633,0.021,0,0,0,29529,POINT (-87.813371 41.995019),60631-20210102
60631,01/31/2021,35,3239,28,2561,0.087,7,678,0.023,29529,POINT (-87.813371 41.995019),60631-20210131
60649,01/08/2021,155,595,134,552,0.012,21,43,0.001,46633,POINT (-87.571522 41.762202),60649-20210108
60613,01/25/2021,201,4706,157,3551,0.07,44,1155,0.023,50761,POINT (-87.661343 41.953742),60613-20210125
60607,12/28/2020,52,1062,52,1062,0.036,0,0,0,29293,POINT (-87.652727 41.876104),60607-20201228
60605,01/24/2021,31,4386,30,2866,0.099,1,1520,0.052,29060,POINT (-87.623449 41.867824),60605-20210124
60632,01/07/2021,58,605,41,580,0.006,17,25,0,89857,POINT (-87.711251 41.810038),60632-20210107
60652,12/29/2020,53,308,53,308,0.007,0,0,0,43447,POINT (-87.714238 41.745398),60652-20201229
60616,01/14/2021,84,2345,56,1721,0.032,28,624,0.012,54197,POINT (-87.629531 41.844869),60616-20210114
60623,01/18/2021,39,1191,24,1034,0.013,15,157,0.002,81283,POINT (-87.717446 41.850321),60623-20210118
60606,01/02/2021,6,129,6,129,0.039,0,0,0,3287,POINT (-87.63676 41.882634),60606-20210102
60652,12/30/2020,54,362,54,362,0.008,0,0,0,43447,POINT (-87.714238 41.745398),60652-20201230
60656,12/27/2020,0,197,0,197,0.007,0,0,0,28218,POINT (-87.817934 41.974566),60656-20201227
60641,12/27/2020,0,442,0,442,0.006,0,0,0,69880,POINT (-87.746791 41.946682),60641-20201227
60666,12/23/2020,0,0,0,0,0,0,0,0,0,POINT (-87.896371 41.979511),60666-20201223
60642,01/14/2021,37,1545,21,1052,0.053,16,493,0.025,19716,POINT (-87.657821 41.899935),60642-20210114
60630,01/10/2021,17,1350,7,1117,0.02,10,233,0.004,56433,POINT (-87.759611 41.971261),60630-20210110
60629,12/26/2020,9,286,9,286,0.003,0,0,0,110029,POINT (-87.711565 41.777061),60629-20201226
60610,01/12/2021,138,1978,58,1414,0.035,80,564,0.014,40548,POINT (-87.63581 41.90455),60610-20210112
60619,12/17/2020,7,7,7,7,0,0,0,0,61207,POINT (-87.60569 41.744737),60619-20201217
60602,01/21/2021,14,175,13,131,0.114,1,44,0.038,1145,POINT (-87.628309 41.883136),60602-20210121
60632,01/25/2021,136,1875,105,1567,0.017,31,308,0.003,89857,POINT (-87.711251 41.810038),60632-20210125
60660,12/29/2020,58,441,58,441,0.01,0,0,0,44498,POINT (-87.666362 41.991062),60660-20201229
60630,01/31/2021,62,3841,54,3035,0.054,8,806,0.014,56433,POINT (-87.759611 41.971261),60630-20210131
60649,01/23/2021,61,1738,53,1545,0.033,8,193,0.004,46633,POINT (-87.571522 41.762202),60649-20210123
60657,01/03/2021,30,2166,29,2165,0.031,1,1,0,70958,POINT (-87.658216 41.939715),60657-20210103
60645,01/25/2021,224,2732,168,2267,0.048,56,465,0.01,47270,POINT (-87.695049 42.008927),60645-20210125
60617,01/26/2021,198,2464,150,2062,0.025,48,402,0.005,83553,POINT (-87.556897 41.721257),60617-20210126
60625,12/25/2020,0,627,0,627,0.008,0,0,0,79444,POINT (-87.701816 41.971155),60625-20201225
60661,01/05/2021,25,537,24,531,0.051,1,6,0.001,10354,POINT (-87.644283 41.882786),60661-20210105
60639,12/15/2020,0,0,0,0,0,0,0,0,88204,POINT (-87.75531 41.920609),60639-20201215
60655,12/20/2020,39,223,39,223,0.008,0,0,0,28569,POINT (-87.701434 41.696456),60655-20201220
60653,01/02/2021,1,400,1,400,0.012,0,0,0,33154,POINT (-87.611244 41.819261),60653-20210102
60644,01/16/2021,20,967,17,893,0.019,3,74,0.002,46591,POINT (-87.756863 41.881113),60644-20210116
60640,01/06/2021,295,1963,272,1926,0.028,23,37,0.001,69363,POINT (-87.662232 41.971888),60640-20210106
60628,01/18/2021,39,814,30,698,0.011,9,116,0.002,64254,POINT (-87.621537 41.694192),60628-20210118
60624,12/29/2020,16,81,16,81,0.002,0,0,0,34892,POINT (-87.722735 41.879417),60624-20201229
60637,12/22/2020,79,256,79,256,0.005,0,0,0,47300,POINT (-87.604053 41.780991),60637-20201222
60645,12/24/2020,11,284,11,284,0.006,0,0,0,47270,POINT (-87.695049 42.008927),60645-20201224
60646,01/07/2021,72,700,33,655,0.023,39,45,0.002,28569,POINT (-87.761826 41.993931),60646-20210107
60636,12/31/2020,9,84,9,84,0.003,0,0,0,30024,POINT (-87.668597 41.77599),60636-20201231
60637,01/08/2021,86,1109,36,976,0.021,50,133,0.003,47300,POINT (-87.604053 41.780991),60637-20210108
60610,01/23/2021,112,3506,101,2636,0.065,11,870,0.021,40548,POINT (-87.63581 41.90455),60610-20210123
60666,01/07/2021,0,0,0,0,0,0,0,0,0,POINT (-87.896371 41.979511),60666-20210107
60643,01/17/2021,10,1612,6,1300,0.027,4,312,0.006,48887,POINT (-87.662381 41.700445),60643-20210117
60619,01/02/2021,7,274,7,274,0.004,0,0,0,61207,POINT (-87.60569 41.744737),60619-20210102
60621,12/24/2020,1,33,1,33,0.001,0,0,0,28018,POINT (-87.638812 41.776931),60621-20201224
60655,12/27/2020,0,380,0,380,0.013,0,0,0,28569,POINT (-87.701434 41.696456),60655-20201227
60637,01/03/2021,84,710,79,705,0.015,5,5,0,47300,POINT (-87.604053 41.780991),60637-20210103
60655,12/25/2020,0,375,0,375,0.013,0,0,0,28569,POINT (-87.701434 41.696456),60655-20201225
60601,12/20/2020,9,148,9,148,0.01,0,0,0,15083,POINT (-87.622844 41.886262),60601-20201220
60623,12/27/2020,0,159,0,159,0.002,0,0,0,81283,POINT (-87.717446 41.850321),60623-20201227
Unknown,12/16/2020,0,0,0,0,0,0,0,0,0,,Unknown-20201216
60612,12/30/2020,97,765,97,765,0.023,0,0,0,33735,POINT (-87.687011 41.88004),60612-20201230
60616,01/19/2021,127,2696,72,1938,0.036,55,758,0.014,54197,POINT (-87.629531 41.844869),60616-20210119
60606,02/12/2021,34,730,19,513,0.156,15,217,0.066,3287,POINT (-87.63676 41.882634),60606-20210212
60602,01/26/2021,15,234,9,182,0.159,6,52,0.045,1145,POINT (-87.628309 41.883136),60602-20210126
60631,01/04/2021,59,701,58,700,0.024,1,1,0,29529,POINT (-87.813371 41.995019),60631-20210104
60629,12/23/2020,46,261,46,261,0.002,0,0,0,110029,POINT (-87.711565 41.777061),60629-20201223
60626,01/05/2021,150,1004,149,1001,0.02,1,3,0,50544,POINT (-87.669834 42.009469),60626-20210105
60617,01/05/2021,59,470,57,465,0.006,2,5,0,83553,POINT (-87.556897 41.721257),60617-20210105
60612,01/04/2021,80,895,79,894,0.027,1,1,0,33735,POINT (-87.687011 41.88004),60612-20210104
60661,01/20/2021,47,1172,18,765,0.074,29,407,0.039,10354,POINT (-87.644283 41.882786),60661-20210120
60606,02/03/2021,11,540,11,388,0.118,0,152,0.046,3287,POINT (-87.63676 41.882634),60606-20210203
60609,01/15/2021,36,968,28,791,0.013,8,177,0.003,60939,POINT (-87.653382 41.812017),60609-20210115
60607,01/27/2021,177,4910,126,3339,0.114,51,1571,0.054,29293,POINT (-87.652727 41.876104),60607-20210127
60660,12/18/2020,93,123,93,123,0.003,0,0,0,44498,POINT (-87.666362 41.991062),60660-20201218
60632,01/24/2021,15,1739,14,1462,0.016,1,277,0.003,89857,POINT (-87.711251 41.810038),60632-20210124
60827,02/21/2021,1,185,0,130,0.005,1,55,0.002,28483,POINT (-87.633087 41.650765),60827-20210221
Unknown,12/27/2020,0,41,0,41,0,0,0,0,0,,Unknown-20201227
Unknown,01/05/2021,13,107,13,107,0,0,0,0,0,,Unknown-20210105
60666,01/24/2021,0,2,0,2,0,0,0,0,0,POINT (-87.896371 41.979511),60666-20210124
60619,01/17/2021,7,908,3,794,0.013,4,114,0.002,61207,POINT (-87.60569 41.744737),60619-20210117
60612,12/18/2020,113,157,113,157,0.005,0,0,0,33735,POINT (-87.687011 41.88004),60612-20201218
60646,01/12/2021,55,981,26,734,0.026,29,247,0.009,28569,POINT (-87.761826 41.993931),60646-20210112
60707,01/17/2021,0,325,0,260,0.006,0,65,0.002,43093,POINT (-87.808283 41.921777),60707-20210117
60616,12/18/2020,159,223,159,223,0.004,0,0,0,54197,POINT (-87.629531 41.844869),60616-20201218
60620,12/19/2020,12,66,12,66,0.001,0,0,0,67711,POINT (-87.651656 41.740873),60620-20201219
60827,12/23/2020,0,6,0,6,0,0,0,0,28483,POINT (-87.633087 41.650765),60827-20201223
60620,12/30/2020,53,245,53,245,0.004,0,0,0,67711,POINT (-87.651656 41.740873),60620-20201230
60601,12/25/2020,0,308,0,308,0.02,0,0,0,15083,POINT (-87.622844 41.886262),60601-20201225
60630,12/26/2020,9,435,9,435,0.008,0,0,0,56433,POINT (-87.759611 41.971261),60630-20201226
60827,01/03/2021,0,9,0,9,0,0,0,0,28483,POINT (-87.633087 41.650765),60827-20210103
60622,01/17/2021,30,4756,14,3444,0.065,16,1312,0.025,53294,POINT (-87.681818 41.902762),60622-20210117
60641,01/24/2021,35,2885,33,2272,0.033,2,613,0.009,69880,POINT (-87.746791 41.946682),60641-20210124
60619,01/06/2021,42,391,39,384,0.006,3,7,0,61207,POINT (-87.60569 41.744737),60619-20210106
60644,01/03/2021,7,306,7,306,0.007,0,0,0,46591,POINT (-87.756863 41.881113),60644-20210103
60636,01/17/2021,3,249,3,221,0.007,0,28,0.001,30024,POINT (-87.668597 41.77599),60636-20210117
60660,01/06/2021,80,881,68,864,0.019,12,17,0,44498,POINT (-87.666362 41.991062),60660-20210106
60637,01/18/2021,181,1905,149,1434,0.03,32,471,0.01,47300,POINT (-87.604053 41.780991),60637-20210118
60649,01/04/2021,17,345,15,343,0.007,2,2,0,46633,POINT (-87.571522 41.762202),60649-20210104
60656,01/17/2021,6,775,5,570,0.02,1,205,0.007,28218,POINT (-87.817934 41.974566),60656-20210117
Unknown,01/15/2021,51,346,51,309,0,0,37,0,0,,Unknown-20210115
60666,01/19/2021,1,2,1,2,0,0,0,0,0,POINT (-87.896371 41.979511),60666-20210119
60647,12/22/2020,152,832,152,832,0.009,0,0,0,87633,POINT (-87.701101 41.921058),60647-20201222
60657,01/18/2021,292,5842,177,4256,0.06,115,1586,0.022,70958,POINT (-87.658216 41.939715),60657-20210118
60622,01/01/2021,2,2093,2,2093,0.039,0,0,0,53294,POINT (-87.681818 41.902762),60622-20210101
60643,12/15/2020,0,0,0,0,0,0,0,0,48887,POINT (-87.662381 41.700445),60643-20201215
60642,12/22/2020,82,445,82,445,0.023,0,0,0,19716,POINT (-87.657821 41.899935),60642-20201222
60653,12/16/2020,0,0,0,0,0,0,0,0,33154,POINT (-87.611244 41.819261),60653-20201216
60666,02/03/2021,1,13,1,13,0,0,0,0,0,POINT (-87.896371 41.979511),60666-20210203
60623,01/24/2021,10,1786,8,1541,0.019,2,245,0.003,81283,POINT (-87.717446 41.850321),60623-20210124
60827,02/04/2021,8,108,7,90,0.003,1,18,0.001,28483,POINT (-87.633087 41.650765),60827-20210204
60628,12/22/2020,17,81,17,81,0.001,0,0,0,64254,POINT (-87.621537 41.694192),60628-20201222
Unknown,01/29/2021,35,928,32,800,0,3,128,0,0,,Unknown-20210129
60646,12/28/2020,18,335,18,335,0.012,0,0,0,28569,POINT (-87.761826 41.993931),60646-20201228
60643,12/30/2020,66,441,66,441,0.009,0,0,0,48887,POINT (-87.662381 41.700445),60643-20201230
60608,12/19/2020,72,225,72,225,0.003,0,0,0,80059,POINT (-87.670366 41.849879),60608-20201219
60646,12/26/2020,8,317,8,317,0.011,0,0,0,28569,POINT (-87.761826 41.993931),60646-20201226
60638,12/25/2020,0,322,0,322,0.005,0,0,0,58669,POINT (-87.771902 41.787032),60638-20201225
60640,01/16/2021,81,4055,67,3334,0.048,14,721,0.01,69363,POINT (-87.662232 41.971888),60640-20210116
60633,02/11/2021,61,801,49,656,0.052,12,145,0.011,12689,POINT (-87.556037 41.653147),60633-20210211
60642,12/17/2020,49,52,49,52,0.003,0,0,0,19716,POINT (-87.657821 41.899935),60642-20201217
60623,01/03/2021,7,414,7,414,0.005,0,0,0,81283,POINT (-87.717446 41.850321),60623-20210103
60611,01/18/2021,226,5243,67,3413,0.103,159,1830,0.055,33224,POINT (-87.620291 41.894734),60611-20210118
60647,12/29/2020,118,1161,118,1161,0.013,0,0,0,87633,POINT (-87.701101 41.921058),60647-20201229
60607,01/16/2021,52,3290,37,2307,0.079,15,983,0.034,29293,POINT (-87.652727 41.876104),60607-20210116
60660,12/23/2020,43,331,43,331,0.007,0,0,0,44498,POINT (-87.666362 41.991062),60660-20201223
60827,12/19/2020,0,4,0,4,0,0,0,0,28483,POINT (-87.633087 41.650765),60827-20201219
60630,12/15/2020,0,0,0,0,0,0,0,0,56433,POINT (-87.759611 41.971261),60630-20201215
60629,01/19/2021,111,1686,65,1353,0.012,46,333,0.003,110029,POINT (-87.711565 41.777061),60629-20210119
60611,01/01/2021,3,2018,3,2018,0.061,0,0,0,33224,POINT (-87.620291 41.894734),60611-20210101
60610,12/28/2020,52,711,52,711,0.018,0,0,0,40548,POINT (-87.63581 41.90455),60610-20201228
60633,01/14/2021,3,125,2,102,0.008,1,23,0.002,12689,POINT (-87.556037 41.653147),60633-20210114
60617,01/11/2021,65,758,29,640,0.008,36,118,0.001,83553,POINT (-87.556897 41.721257),60617-20210111
Unknown,01/20/2021,72,521,48,441,0,24,80,0,0,,Unknown-20210120
60633,12/31/2020,3,48,3,48,0.004,0,0,0,12689,POINT (-87.556037 41.653147),60633-20201231
60625,12/15/2020,0,0,0,0,0,0,0,0,79444,POINT (-87.701816 41.971155),60625-20201215
60607,12/19/2020,162,511,162,511,0.017,0,0,0,29293,POINT (-87.652727 41.876104),60607-20201219
60651,01/12/2021,58,578,42,502,0.008,16,76,0.001,63492,POINT (-87.741017 41.901964),60651-20210112
60666,02/25/2021,0,31,0,23,0,0,8,0,0,POINT (-87.896371 41.979511),60666-20210225
60618,12/16/2020,3,3,3,3,0,0,0,0,94907,POINT (-87.703343 41.946699),60618-20201216
60652,01/11/2021,32,653,12,572,0.013,20,81,0.002,43447,POINT (-87.714238 41.745398),60652-20210111
60827,01/24/2021,0,48,0,42,0.001,0,6,0,28483,POINT (-87.633087 41.650765),60827-20210124
Unknown,02/01/2021,15,970,13,831,0,2,139,0,0,,Unknown-20210201
60617,12/27/2020,0,202,0,202,0.002,0,0,0,83553,POINT (-87.556897 41.721257),60617-20201227
60657,12/17/2020,132,142,132,142,0.002,0,0,0,70958,POINT (-87.658216 41.939715),60657-20201217
60610,01/29/2021,288,4689,270,3573,0.088,18,1116,0.028,40548,POINT (-87.63581 41.90455),60610-20210129
60616,02/05/2021,406,6353,343,4891,0.09,63,1462,0.027,54197,POINT (-87.629531 41.844869),60616-20210205
60660,01/19/2021,95,2501,54,2089,0.047,41,412,0.009,44498,POINT (-87.666362 41.991062),60660-20210119
60633,01/25/2021,13,266,9,214,0.017,4,52,0.004,12689,POINT (-87.556037 41.653147),60633-20210125
60629,01/24/2021,20,2378,19,1957,0.018,1,421,0.004,110029,POINT (-87.711565 41.777061),60629-20210124
60623,01/29/2021,244,2796,220,2341,0.029,24,455,0.006,81283,POINT (-87.717446 41.850321),60623-20210129
60618,12/31/2020,80,1412,80,1412,0.015,0,0,0,94907,POINT (-87.703343 41.946699),60618-20201231
60643,12/16/2020,1,1,1,1,0,0,0,0,48887,POINT (-87.662381 41.700445),60643-20201216
60661,12/19/2020,61,197,61,197,0.019,0,0,0,10354,POINT (-87.644283 41.882786),60661-20201219
60622,12/17/2020,135,138,135,138,0.003,0,0,0,53294,POINT (-87.681818 41.902762),60622-20201217
60636,12/21/2020,8,17,8,17,0.001,0,0,0,30024,POINT (-87.668597 41.77599),60636-20201221
60640,12/30/2020,205,1135,205,1135,0.016,0,0,0,69363,POINT (-87.662232 41.971888),60640-20201230
60613,12/24/2020,37,804,37,804,0.016,0,0,0,50761,POINT (-87.661343 41.953742),60613-20201224
60645,01/21/2021,152,2299,124,1910,0.04,28,389,0.008,47270,POINT (-87.695049 42.008927),60645-20210121
60626,12/19/2020,58,162,58,162,0.003,0,0,0,50544,POINT (-87.669834 42.009469),60626-20201219
60605,01/12/2021,229,3107,71,2068,0.071,158,1039,0.036,29060,POINT (-87.623449 41.867824),60605-20210112
60666,02/20/2021,0,26,0,23,0,0,3,0,0,POINT (-87.896371 41.979511),60666-20210220
60628,12/29/2020,35,178,35,178,0.003,0,0,0,64254,POINT (-87.621537 41.694192),60628-20201229
60618,01/12/2021,250,3096,130,2355,0.025,120,741,0.008,94907,POINT (-87.703343 41.946699),60618-20210112
60620,01/09/2021,21,637,17,572,0.008,4,65,0.001,67711,POINT (-87.651656 41.740873),60620-20210109
60632,01/04/2021,48,471,47,470,0.005,1,1,0,89857,POINT (-87.711251 41.810038),60632-20210104
60609,01/30/2021,91,2496,76,2070,0.034,15,426,0.007,60939,POINT (-87.653382 41.812017),60609-20210130
60645,12/15/2020,1,1,1,1,0,0,0,0,47270,POINT (-87.695049 42.008927),60645-20201215
60636,12/16/2020,0,0,0,0,0,0,0,0,30024,POINT (-87.668597 41.77599),60636-20201216
60625,01/26/2021,258,4855,179,3769,0.047,79,1086,0.014,79444,POINT (-87.701816 41.971155),60625-20210126
60646,12/31/2020,35,460,35,460,0.016,0,0,0,28569,POINT (-87.761826 41.993931),60646-20201231
60641,01/05/2021,76,903,76,903,0.013,0,0,0,69880,POINT (-87.746791 41.946682),60641-20210105
60606,12/29/2020,5,102,5,102,0.031,0,0,0,3287,POINT (-87.63676 41.882634),60606-20201229
60638,01/17/2021,16,1405,14,1076,0.018,2,329,0.006,58669,POINT (-87.771902 41.787032),60638-20210117
60616,01/10/2021,37,1760,9,1389,0.026,28,371,0.007,54197,POINT (-87.629531 41.844869),60616-20210110
60656,12/31/2020,14,285,14,285,0.01,0,0,0,28218,POINT (-87.817934 41.974566),60656-20201231
60623,01/14/2021,58,1071,50,934,0.011,8,137,0.002,81283,POINT (-87.717446 41.850321),60623-20210114
60624,01/25/2021,51,695,36,582,0.017,15,113,0.003,34892,POINT (-87.722735 41.879417),60624-20210125
60649,01/19/2021,189,1266,173,1127,0.024,16,139,0.003,46633,POINT (-87.571522 41.762202),60649-20210119
60630,01/16/2021,69,1924,63,1507,0.027,6,417,0.007,56433,POINT (-87.759611 41.971261),60630-20210116
60644,01/22/2021,81,1240,78,1113,0.024,3,127,0.003,46591,POINT (-87.756863 41.881113),60644-20210122
60651,01/25/2021,90,1317,67,1101,0.017,23,216,0.003,63492,POINT (-87.741017 41.901964),60651-20210125
60632,12/23/2020,25,143,25,143,0.002,0,0,0,89857,POINT (-87.711251 41.810038),60632-20201223
60641,12/23/2020,49,407,49,407,0.006,0,0,0,69880,POINT (-87.746791 41.946682),60641-20201223
60651,01/30/2021,69,1961,56,1656,0.026,13,305,0.005,63492,POINT (-87.741017 41.901964),60651-20210130
60628,01/02/2021,3,235,3,235,0.004,0,0,0,64254,POINT (-87.621537 41.694192),60628-20210102
60653,01/06/2021,30,489,21,476,0.014,9,13,0,33154,POINT (-87.611244 41.819261),60653-20210106
60633,12/29/2020,7,37,7,37,0.003,0,0,0,12689,POINT (-87.556037 41.653147),60633-20201229
60655,12/30/2020,59,499,59,499,0.017,0,0,0,28569,POINT (-87.701434 41.696456),60655-20201230
60601,01/26/2021,64,1530,36,1085,0.072,28,445,0.03,15083,POINT (-87.622844 41.886262),60601-20210126
60630,01/27/2021,220,3212,177,2493,0.044,43,719,0.013,56433,POINT (-87.759611 41.971261),60630-20210127
60649,12/18/2020,28,41,28,41,0.001,0,0,0,46633,POINT (-87.571522 41.762202),60649-20201218
60621,12/31/2020,2,179,2,179,0.006,0,0,0,28018,POINT (-87.638812 41.776931),60621-20201231
60613,01/21/2021,250,4071,208,2999,0.059,42,1072,0.021,50761,POINT (-87.661343 41.953742),60613-20210121
60666,12/18/2020,0,0,0,0,0,0,0,0,0,POINT (-87.896371 41.979511),60666-20201218
Unknown,03/02/2021,35,2168,20,1344,0,15,824,0,0,,Unknown-20210302
60611,12/17/2020,172,187,172,187,0.006,0,0,0,33224,POINT (-87.620291 41.894734),60611-20201217
60657,01/07/2021,300,3022,101,2751,0.039,199,271,0.004,70958,POINT (-87.658216 41.939715),60657-20210107
60610,12/22/2020,97,577,97,577,0.014,0,0,0,40548,POINT (-87.63581 41.90455),60610-20201222
60606,01/11/2021,23,228,5,161,0.049,18,67,0.02,3287,POINT (-87.63676 41.882634),60606-20210111
60601,01/08/2021,85,660,23,548,0.036,62,112,0.007,15083,POINT (-87.622844 41.886262),60601-20210108
Unknown,12/31/2020,3,87,3,87,0,0,0,0,0,,Unknown-20201231
60642,01/30/2021,49,2637,28,1792,0.091,21,845,0.043,19716,POINT (-87.657821 41.899935),60642-20210130
60645,01/16/2021,33,1840,29,1568,0.033,4,272,0.006,47270,POINT (-87.695049 42.008927),60645-20210116
60622,12/27/2020,0,1378,0,1378,0.026,0,0,0,53294,POINT (-87.681818 41.902762),60622-20201227
60622,12/22/2020,198,1213,198,1213,0.023,0,0,0,53294,POINT (-87.681818 41.902762),60622-20201222
60640,12/15/2020,0,0,0,0,0,0,0,0,69363,POINT (-87.662232 41.971888),60640-20201215
60645,12/20/2020,11,147,11,147,0.003,0,0,0,47270,POINT (-87.695049 42.008927),60645-20201220
60643,01/04/2021,31,514,31,513,0.01,0,1,0,48887,POINT (-87.662381 41.700445),60643-20210104
60628,01/23/2021,58,1320,58,1129,0.018,0,191,0.003,64254,POINT (-87.621537 41.694192),60628-20210123
60626,01/01/2021,0,748,0,748,0.015,0,0,0,50544,POINT (-87.669834 42.009469),60626-20210101
60623,12/23/2020,34,147,34,147,0.002,0,0,0,81283,POINT (-87.717446 41.850321),60623-20201223
60625,01/16/2021,83,2959,75,2346,0.03,8,613,0.008,79444,POINT (-87.701816 41.971155),60625-20210116
60605,12/23/2020,133,1166,133,1166,0.04,0,0,0,29060,POINT (-87.623449 41.867824),60605-20201223
60629,01/14/2021,97,1328,84,1078,0.01,13,250,0.002,110029,POINT (-87.711565 41.777061),60629-20210114
Unknown,02/16/2021,14,1614,10,1109,0,4,505,0,0,,Unknown-20210216
60608,01/03/2021,10,936,10,936,0.012,0,0,0,80059,POINT (-87.670366 41.849879),60608-20210103
Unknown,12/20/2020,1,10,1,10,0,0,0,0,0,,Unknown-20201220
60639,01/01/2021,0,378,0,378,0.004,0,0,0,88204,POINT (-87.75531 41.920609),60639-20210101
60661,01/16/2021,22,1058,17,718,0.069,5,340,0.033,10354,POINT (-87.644283 41.882786),60661-20210116
60639,12/26/2020,1,217,1,217,0.002,0,0,0,88204,POINT (-87.75531 41.920609),60639-20201226
60606,01/30/2021,13,497,9,354,0.108,4,143,0.044,3287,POINT (-87.63676 41.882634),60606-20210130
60624,12/24/2020,1,58,1,58,0.002,0,0,0,34892,POINT (-87.722735 41.879417),60624-20201224
60601,01/21/2021,98,1246,86,865,0.057,12,381,0.025,15083,POINT (-87.622844 41.886262),60601-20210121
60617,01/01/2021,1,363,1,363,0.004,0,0,0,83553,POINT (-87.556897 41.721257),60617-20210101
Unknown,12/23/2020,8,35,8,35,0,0,0,0,0,,Unknown-20201223
60707,01/05/2021,11,144,11,143,0.003,0,1,0,43093,POINT (-87.808283 41.921777),60707-20210105
60620,12/15/2020,0,0,0,0,0,0,0,0,67711,POINT (-87.651656 41.740873),60620-20201215
60651,12/24/2020,6,112,6,112,0.002,0,0,0,63492,POINT (-87.741017 41.901964),60651-20201224
60601,01/09/2021,45,705,11,559,0.037,34,146,0.01,15083,POINT (-87.622844 41.886262),60601-20210109
60617,12/21/2020,34,116,34,116,0.001,0,0,0,83553,POINT (-87.556897 41.721257),60617-20201221
60652,01/06/2021,21,492,15,484,0.011,6,8,0,43447,POINT (-87.714238 41.745398),60652-20210106
60625,12/30/2020,135,906,135,906,0.011,0,0,0,79444,POINT (-87.701816 41.971155),60625-20201230
60636,01/13/2021,20,216,15,192,0.006,5,24,0.001,30024,POINT (-87.668597 41.77599),60636-20210113
60647,12/25/2020,0,971,0,971,0.011,0,0,0,87633,POINT (-87.701101 41.921058),60647-20201225
60666,01/02/2021,0,0,0,0,0,0,0,0,0,POINT (-87.896371 41.979511),60666-20210102
60609,01/11/2021,51,747,17,641,0.011,34,106,0.002,60939,POINT (-87.653382 41.812017),60609-20210111
60660,01/21/2021,192,2805,160,2334,0.052,32,471,0.011,44498,POINT (-87.666362 41.991062),60660-20210121
Unknown,01/19/2021,65,449,51,393,0,14,56,0,0,,Unknown-20210119
60637,12/17/2020,24,26,24,26,0.001,0,0,0,47300,POINT (-87.604053 41.780991),60637-20201217
60619,12/20/2020,4,49,4,49,0.001,0,0,0,61207,POINT (-87.60569 41.744737),60619-20201220
60610,01/06/2021,67,1187,55,1158,0.029,12,29,0.001,40548,POINT (-87.63581 41.90455),60610-20210106
60660,01/10/2021,12,1798,7,1605,0.036,5,193,0.004,44498,POINT (-87.666362 41.991062),60660-20210110
60644,12/21/2020,17,47,17,47,0.001,0,0,0,46591,POINT (-87.756863 41.881113),60644-20201221
60827,12/30/2020,1,9,1,9,0,0,0,0,28483,POINT (-87.633087 41.650765),60827-20201230
60666,02/24/2021,4,31,0,23,0,4,8,0,0,POINT (-87.896371 41.979511),60666-20210224
60617,01/23/2021,119,2092,118,1767,0.021,1,325,0.004,83553,POINT (-87.556897 41.721257),60617-20210123
60644,01/07/2021,21,624,12,613,0.013,9,11,0,46591,POINT (-87.756863 41.881113),60644-20210107
60827,01/06/2021,2,13,2,13,0,0,0,0,28483,POINT (-87.633087 41.650765),60827-20210106
60601,12/29/2020,27,367,27,367,0.024,0,0,0,15083,POINT (-87.622844 41.886262),60601-20201229
60640,01/14/2021,194,3843,169,3146,0.045,25,697,0.01,69363,POINT (-87.662232 41.971888),60640-20210114
60827,12/15/2020,0,0,0,0,0,0,0,0,28483,POINT (-87.633087 41.650765),60827-20201215
60608,01/08/2021,188,1472,88,1302,0.016,100,170,0.002,80059,POINT (-87.670366 41.849879),60608-20210108
Unknown,12/26/2020,3,41,3,41,0,0,0,0,0,,Unknown-20201226
60619,01/10/2021,12,519,7,467,0.008,5,52,0.001,61207,POINT (-87.60569 41.744737),60619-20210110
60638,12/20/2020,27,170,27,170,0.003,0,0,0,58669,POINT (-87.771902 41.787032),60638-20201220
60639,12/21/2020,42,132,42,132,0.001,0,0,0,88204,POINT (-87.75531 41.920609),60639-20201221
60827,01/23/2021,0,48,0,42,0.001,0,6,0,28483,POINT (-87.633087 41.650765),60827-20210123
60666,02/07/2021,0,14,0,14,0,0,0,0,0,POINT (-87.896371 41.979511),60666-20210207
60628,12/26/2020,1,112,1,112,0.002,0,0,0,64254,POINT (-87.621537 41.694192),60628-20201226
60657,12/29/2020,173,1793,173,1793,0.025,0,0,0,70958,POINT (-87.658216 41.939715),60657-20201229
60625,01/19/2021,133,3257,83,2541,0.032,50,716,0.009,79444,POINT (-87.701816 41.971155),60625-20210119
60637,01/30/2021,67,3757,49,2907,0.061,18,850,0.018,47300,POINT (-87.604053 41.780991),60637-20210130
60623,01/28/2021,218,2552,175,2121,0.026,43,431,0.005,81283,POINT (-87.717446 41.850321),60623-20210128
60643,12/26/2020,1,313,1,313,0.006,0,0,0,48887,POINT (-87.662381 41.700445),60643-20201226
60622,01/06/2021,193,2582,172,2539,0.048,21,43,0.001,53294,POINT (-87.681818 41.902762),60622-20210106
60638,01/09/2021,56,941,20,785,0.013,36,156,0.003,58669,POINT (-87.771902 41.787032),60638-20210109
60637,12/30/2020,122,572,122,572,0.012,0,0,0,47300,POINT (-87.604053 41.780991),60637-20201230
60610,01/01/2021,2,902,2,902,0.022,0,0,0,40548,POINT (-87.63581 41.90455),60610-20210101
60611,12/20/2020,21,916,21,916,0.028,0,0,0,33224,POINT (-87.620291 41.894734),60611-20201220
60642,12/19/2020,78,265,78,265,0.013,0,0,0,19716,POINT (-87.657821 41.899935),60642-20201219
60652,01/07/2021,43,535,30,514,0.012,13,21,0,43447,POINT (-87.714238 41.745398),60652-20210107
60666,01/31/2021,0,9,0,9,0,0,0,0,0,POINT (-87.896371 41.979511),60666-20210131
60631,12/22/2020,30,311,30,311,0.011,0,0,0,29529,POINT (-87.813371 41.995019),60631-20201222
60607,01/20/2021,257,3799,127,2549,0.087,130,1250,0.043,29293,POINT (-87.652727 41.876104),60607-20210120
60660,12/27/2020,0,347,0,347,0.008,0,0,0,44498,POINT (-87.666362 41.991062),60660-20201227
60642,01/03/2021,7,717,7,717,0.036,0,0,0,19716,POINT (-87.657821 41.899935),60642-20210103
60602,01/16/2021,7,121,7,91,0.079,0,30,0.026,1145,POINT (-87.628309 41.883136),60602-20210116
Unknown,02/05/2021,78,1218,34,948,0,44,270,0,0,,Unknown-20210205
60651,01/13/2021,46,624,29,531,0.008,17,93,0.001,63492,POINT (-87.741017 41.901964),60651-20210113
60707,12/15/2020,0,0,0,0,0,0,0,0,43093,POINT (-87.808283 41.921777),60707-20201215
60618,12/19/2020,149,426,149,426,0.004,0,0,0,94907,POINT (-87.703343 41.946699),60618-20201219
60633,01/10/2021,1,99,1,88,0.007,0,11,0.001,12689,POINT (-87.556037 41.653147),60633-20210110
60624,01/16/2021,10,432,8,377,0.011,2,55,0.002,34892,POINT (-87.722735 41.879417),60624-20210116
60617,12/31/2020,19,362,19,362,0.004,0,0,0,83553,POINT (-87.556897 41.721257),60617-20201231
60661,01/28/2021,65,1478,48,964,0.093,17,514,0.05,10354,POINT (-87.644283 41.882786),60661-20210128
60630,01/17/2021,20,1944,13,1520,0.027,7,424,0.008,56433,POINT (-87.759611 41.971261),60630-20210117
60649,01/16/2021,13,1016,13,904,0.019,0,112,0.002,46633,POINT (-87.571522 41.762202),60649-20210116
60656,01/29/2021,98,1516,87,1187,0.042,11,329,0.012,28218,POINT (-87.817934 41.974566),60656-20210129
60651,01/08/2021,60,460,33,422,0.007,27,38,0.001,63492,POINT (-87.741017 41.901964),60651-20210108
60643,01/12/2021,81,1096,41,835,0.017,40,261,0.005,48887,POINT (-87.662381 41.700445),60643-20210112
60637,01/14/2021,61,1470,46,1131,0.024,15,339,0.007,47300,POINT (-87.604053 41.780991),60637-20210114
60620,01/13/2021,63,797,50,673,0.01,13,124,0.002,67711,POINT (-87.651656 41.740873),60620-20210113
60631,12/27/2020,0,347,0,347,0.012,0,0,0,29529,POINT (-87.813371 41.995019),60631-20201227
60610,12/15/2020,0,0,0,0,0,0,0,0,40548,POINT (-87.63581 41.90455),60610-20201215
60611,01/06/2021,76,2416,47,2360,0.071,29,56,0.002,33224,POINT (-87.620291 41.894734),60611-20210106
60602,01/31/2021,1,283,0,224,0.196,1,59,0.052,1145,POINT (-87.628309 41.883136),60602-20210131
60605,01/16/2021,53,3503,29,2285,0.079,24,1218,0.042,29060,POINT (-87.623449 41.867824),60605-20210116
60643,12/20/2020,26,154,26,154,0.003,0,0,0,48887,POINT (-87.662381 41.700445),60643-20201220
60617,01/15/2021,118,1094,109,900,0.011,9,194,0.002,83553,POINT (-87.556897 41.721257),60617-20210115
60630,12/16/2020,4,4,4,4,0,0,0,0,56433,POINT (-87.759611 41.971261),60630-20201216
60621,01/01/2021,0,179,0,179,0.006,0,0,0,28018,POINT (-87.638812 41.776931),60621-20210101
60645,12/19/2020,49,136,49,136,0.003,0,0,0,47270,POINT (-87.695049 42.008927),60645-20201219
60653,12/20/2020,12,70,12,70,0.002,0,0,0,33154,POINT (-87.611244 41.819261),60653-20201220
60642,01/31/2021,13,2650,10,1802,0.091,3,848,0.043,19716,POINT (-87.657821 41.899935),60642-20210131
60611,01/21/2021,448,6022,423,4016,0.121,25,2006,0.06,33224,POINT (-87.620291 41.894734),60611-20210121
60640,12/26/2020,17,742,17,742,0.011,0,0,0,69363,POINT (-87.662232 41.971888),60640-20201226
60606,02/23/2021,25,914,12,591,0.18,13,323,0.098,3287,POINT (-87.63676 41.882634),60606-20210223
60605,01/29/2021,230,5274,191,3506,0.121,39,1768,0.061,29060,POINT (-87.623449 41.867824),60605-20210129
60616,01/05/2021,154,1181,143,1159,0.021,11,22,0,54197,POINT (-87.629531 41.844869),60616-20210105
60653,12/15/2020,0,0,0,0,0,0,0,0,33154,POINT (-87.611244 41.819261),60653-20201215
60637,01/23/2021,132,2890,90,2219,0.047,42,671,0.014,47300,POINT (-87.604053 41.780991),60637-20210123
60827,01/28/2021,8,70,6,60,0.002,2,10,0,28483,POINT (-87.633087 41.650765),60827-20210128
60624,01/22/2021,46,625,42,528,0.015,4,97,0.003,34892,POINT (-87.722735 41.879417),60624-20210122
60633,02/23/2021,43,1149,27,850,0.067,16,299,0.024,12689,POINT (-87.556037 41.653147),60633-20210223
60633,02/01/2021,13,430,13,357,0.028,0,73,0.006,12689,POINT (-87.556037 41.653147),60633-20210201
60629,01/04/2021,42,602,41,601,0.005,1,1,0,110029,POINT (-87.711565 41.777061),60629-20210104
60649,12/22/2020,17,81,17,81,0.002,0,0,0,46633,POINT (-87.571522 41.762202),60649-20201222
60660,01/15/2021,75,2252,70,1922,0.043,5,330,0.007,44498,POINT (-87.666362 41.991062),60660-20210115
60666,02/13/2021,0,23,0,21,0,0,2,0,0,POINT (-87.896371 41.979511),60666-20210213
60642,12/16/2020,3,3,3,3,0,0,0,0,19716,POINT (-87.657821 41.899935),60642-20201216
60613,12/28/2020,79,902,79,902,0.018,0,0,0,50761,POINT (-87.661343 41.953742),60613-20201228
60638,12/30/2020,80,510,80,510,0.009,0,0,0,58669,POINT (-87.771902 41.787032),60638-20201230
60632,12/31/2020,30,403,30,403,0.004,0,0,0,89857,POINT (-87.711251 41.810038),60632-20201231
60633,12/17/2020,2,2,2,2,0,0,0,0,12689,POINT (-87.556037 41.653147),60633-20201217
60608,12/28/2020,35,606,35,606,0.008,0,0,0,80059,POINT (-87.670366 41.849879),60608-20201228
60624,12/21/2020,11,35,11,35,0.001,0,0,0,34892,POINT (-87.722735 41.879417),60624-20201221
60601,01/30/2021,34,1834,22,1332,0.088,12,502,0.033,15083,POINT (-87.622844 41.886262),60601-20210130
60609,12/29/2020,37,243,37,243,0.004,0,0,0,60939,POINT (-87.653382 41.812017),60609-20201229
60625,01/02/2021,32,1024,32,1024,0.013,0,0,0,79444,POINT (-87.701816 41.971155),60625-20210102
60625,01/04/2021,136,1308,132,1304,0.016,4,4,0,79444,POINT (-87.701816 41.971155),60625-20210104
60613,01/17/2021,41,3345,24,2520,0.05,17,825,0.016,50761,POINT (-87.661343 41.953742),60613-20210117
60656,01/04/2021,30,340,30,340,0.012,0,0,0,28218,POINT (-87.817934 41.974566),60656-20210104
Unknown,02/15/2021,15,1600,11,1099,0,4,501,0,0,,Unknown-20210215
60646,01/04/2021,52,533,52,533,0.019,0,0,0,28569,POINT (-87.761826 41.993931),60646-20210104
60646,01/15/2021,55,1259,51,957,0.033,4,302,0.011,28569,POINT (-87.761826 41.993931),60646-20210115
Unknown,12/30/2020,24,84,24,84,0,0,0,0,0,,Unknown-20201230
60601,01/04/2021,34,463,32,461,0.031,2,2,0,15083,POINT (-87.622844 41.886262),60601-20210104
60628,01/05/2021,24,397,24,396,0.006,0,1,0,64254,POINT (-87.621537 41.694192),60628-20210105
60606,01/15/2021,8,271,7,183,0.056,1,88,0.027,3287,POINT (-87.63676 41.882634),60606-20210115
60612,12/27/2020,0,527,0,527,0.016,0,0,0,33735,POINT (-87.687011 41.88004),60612-20201227
60602,12/30/2020,5,44,5,44,0.038,0,0,0,1145,POINT (-87.628309 41.883136),60602-20201230
60632,01/17/2021,11,1069,6,913,0.01,5,156,0.002,89857,POINT (-87.711251 41.810038),60632-20210117
Unknown,01/04/2021,4,94,4,94,0,0,0,0,0,,Unknown-20210104
60618,01/05/2021,153,1794,147,1776,0.019,6,18,0,94907,POINT (-87.703343 41.946699),60618-20210105
60621,12/27/2020,0,34,0,34,0.001,0,0,0,28018,POINT (-87.638812 41.776931),60621-20201227
60655,01/03/2021,12,670,12,670,0.023,0,0,0,28569,POINT (-87.701434 41.696456),60655-20210103
60644,01/02/2021,86,299,86,299,0.006,0,0,0,46591,POINT (-87.756863 41.881113),60644-20210102
Unknown,02/26/2021,59,2064,27,1277,0,32,787,0,0,,Unknown-20210226
60623,01/09/2021,35,777,27,732,0.009,8,45,0.001,81283,POINT (-87.717446 41.850321),60623-20210109
60661,01/11/2021,57,860,7,608,0.059,50,252,0.024,10354,POINT (-87.644283 41.882786),60661-20210111
60612,01/07/2021,102,1100,44,1030,0.031,58,70,0.002,33735,POINT (-87.687011 41.88004),60612-20210107
60642,01/26/2021,95,2280,46,1534,0.078,49,746,0.038,19716,POINT (-87.657821 41.899935),60642-20210126
60606,01/10/2021,3,205,0,156,0.047,3,49,0.015,3287,POINT (-87.63676 41.882634),60606-20210110
60605,12/28/2020,55,1274,55,1274,0.044,0,0,0,29060,POINT (-87.623449 41.867824),60605-20201228
60645,01/20/2021,152,2147,107,1786,0.038,45,361,0.008,47270,POINT (-87.695049 42.008927),60645-20210120
60827,01/11/2021,1,20,1,18,0.001,0,2,0,28483,POINT (-87.633087 41.650765),60827-20210111
60655,12/17/2020,41,41,41,41,0.001,0,0,0,28569,POINT (-87.701434 41.696456),60655-20201217
60621,12/23/2020,4,32,4,32,0.001,0,0,0,28018,POINT (-87.638812 41.776931),60621-20201223
60666,12/15/2020,0,0,0,0,0,0,0,0,0,POINT (-87.896371 41.979511),60666-20201215
60638,12/15/2020,0,0,0,0,0,0,0,0,58669,POINT (-87.771902 41.787032),60638-20201215
Unknown,01/14/2021,44,295,39,258,0,5,37,0,0,,Unknown-20210114
60622,12/18/2020,313,451,313,451,0.008,0,0,0,53294,POINT (-87.681818 41.902762),60622-20201218
60652,01/26/2021,98,1530,72,1157,0.027,26,373,0.009,43447,POINT (-87.714238 41.745398),60652-20210126
60827,02/24/2021,10,205,6,142,0.005,4,63,0.002,28483,POINT (-87.633087 41.650765),60827-20210224
60666,12/30/2020,0,0,0,0,0,0,0,0,0,POINT (-87.896371 41.979511),60666-20201230
60606,02/11/2021,31,696,13,494,0.15,18,202,0.061,3287,POINT (-87.63676 41.882634),60606-20210211
60631,01/23/2021,83,2189,78,1773,0.06,5,416,0.014,29529,POINT (-87.813371 41.995019),60631-20210123
60624,01/05/2021,21,169,21,169,0.005,0,0,0,34892,POINT (-87.722735 41.879417),60624-20210105
60707,12/29/2020,17,98,17,98,0.002,0,0,0,43093,POINT (-87.808283 41.921777),60707-20201229
60620,12/27/2020,0,135,0,135,0.002,0,0,0,67711,POINT (-87.651656 41.740873),60620-20201227
60656,01/14/2021,45,723,34,527,0.019,11,196,0.007,28218,POINT (-87.817934 41.974566),60656-20210114
60641,01/09/2021,66,1305,26,1095,0.016,40,210,0.003,69880,POINT (-87.746791 41.946682),60641-20210109
60605,12/19/2020,165,566,165,566,0.019,0,0,0,29060,POINT (-87.623449 41.867824),60605-20201219
60660,01/25/2021,146,3223,104,2674,0.06,42,549,0.012,44498,POINT (-87.666362 41.991062),60660-20210125
60626,12/28/2020,24,363,24,363,0.007,0,0,0,50544,POINT (-87.669834 42.009469),60626-20201228
Unknown,02/20/2021,24,1825,8,1176,0,16,649,0,0,,Unknown-20210220
60666,01/06/2021,0,0,0,0,0,0,0,0,0,POINT (-87.896371 41.979511),60666-20210106
60707,01/09/2021,14,202,10,182,0.004,4,20,0,43093,POINT (-87.808283 41.921777),60707-20210109
60651,12/29/2020,26,170,26,170,0.003,0,0,0,63492,POINT (-87.741017 41.901964),60651-20201229
60602,12/15/2020,0,0,0,0,0,0,0,0,1145,POINT (-87.628309 41.883136),60602-20201215
60666,01/16/2021,0,1,0,1,0,0,0,0,0,POINT (-87.896371 41.979511),60666-20210116
60625,12/18/2020,160,197,160,197,0.002,0,0,0,79444,POINT (-87.701816 41.971155),60625-20201218
60644,01/17/2021,6,973,5,898,0.019,1,75,0.002,46591,POINT (-87.756863 41.881113),60644-20210117
60661,12/27/2020,0,359,0,359,0.035,0,0,0,10354,POINT (-87.644283 41.882786),60661-20201227
60601,01/13/2021,51,908,28,629,0.042,23,279,0.018,15083,POINT (-87.622844 41.886262),60601-20210113
60639,01/05/2021,64,547,63,542,0.006,1,5,0,88204,POINT (-87.75531 41.920609),60639-20210105
60666,02/17/2021,1,24,1,22,0,0,2,0,0,POINT (-87.896371 41.979511),60666-20210217
60633,01/22/2021,27,231,21,186,0.015,6,45,0.004,12689,POINT (-87.556037 41.653147),60633-20210122
60649,12/29/2020,131,274,131,274,0.006,0,0,0,46633,POINT (-87.571522 41.762202),60649-20201229
60630,01/22/2021,159,2558,143,1977,0.035,16,581,0.01,56433,POINT (-87.759611 41.971261),60630-20210122
60657,12/31/2020,59,2068,59,2068,0.029,0,0,0,70958,POINT (-87.658216 41.939715),60657-20201231
60666,01/27/2021,1,5,1,5,0,0,0,0,0,POINT (-87.896371 41.979511),60666-20210127
60620,12/22/2020,25,107,25,107,0.002,0,0,0,67711,POINT (-87.651656 41.740873),60620-20201222
60645,01/30/2021,89,3951,73,3170,0.067,16,781,0.017,47270,POINT (-87.695049 42.008927),60645-20210130
60619,12/26/2020,0,121,0,121,0.002,0,0,0,61207,POINT (-87.60569 41.744737),60619-20201226
60607,12/22/2020,161,846,161,846,0.029,0,0,0,29293,POINT (-87.652727 41.876104),60607-20201222
60607,01/08/2021,278,2266,71,1890,0.065,207,376,0.013,29293,POINT (-87.652727 41.876104),60607-20210108
60666,01/12/2021,0,0,0,0,0,0,0,0,0,POINT (-87.896371 41.979511),60666-20210112
60622,01/10/2021,54,3509,16,2760,0.052,38,749,0.014,53294,POINT (-87.681818 41.902762),60622-20210110
60661,01/23/2021,20,1282,16,848,0.082,4,434,0.042,10354,POINT (-87.644283 41.882786),60661-20210123
60827,02/12/2021,5,144,3,117,0.004,2,27,0.001,28483,POINT (-87.633087 41.650765),60827-20210212
60644,12/16/2020,0,0,0,0,0,0,0,0,46591,POINT (-87.756863 41.881113),60644-20201216
60611,12/24/2020,27,1616,27,1616,0.049,0,0,0,33224,POINT (-87.620291 41.894734),60611-20201224
60666,02/28/2021,0,33,0,23,0,0,10,0,0,POINT (-87.896371 41.979511),60666-20210228
60827,02/07/2021,3,120,3,100,0.004,0,20,0.001,28483,POINT (-87.633087 41.650765),60827-20210207
60642,01/17/2021,11,1653,6,1136,0.058,5,517,0.026,19716,POINT (-87.657821 41.899935),60642-20210117
60624,01/01/2021,0,118,0,118,0.003,0,0,0,34892,POINT (-87.722735 41.879417),60624-20210101
60633,02/04/2021,35,532,25,442,0.035,10,90,0.007,12689,POINT (-87.556037 41.653147),60633-20210204
60641,01/16/2021,80,1988,67,1564,0.022,13,424,0.006,69880,POINT (-87.746791 41.946682),60641-20210116
60625,01/23/2021,128,4290,117,3373,0.042,11,917,0.012,79444,POINT (-87.701816 41.971155),60625-20210123
60649,01/01/2021,0,309,0,309,0.007,0,0,0,46633,POINT (-87.571522 41.762202),60649-20210101
60646,01/23/2021,183,2034,174,1619,0.057,9,415,0.015,28569,POINT (-87.761826 41.993931),60646-20210123
60647,01/05/2021,120,1614,111,1598,0.018,9,16,0,87633,POINT (-87.701101 41.921058),60647-20210105
60656,01/07/2021,46,436,8,392,0.014,38,44,0.002,28218,POINT (-87.817934 41.974566),60656-20210107
60660,01/30/2021,100,4137,89,3375,0.076,11,762,0.017,44498,POINT (-87.666362 41.991062),60660-20210130
60606,02/06/2021,7,607,4,439,0.134,3,168,0.051,3287,POINT (-87.63676 41.882634),60606-20210206
60656,01/24/2021,17,1093,14,839,0.03,3,254,0.009,28218,POINT (-87.817934 41.974566),60656-20210124
60827,03/01/2021,7,250,4,176,0.006,3,74,0.003,28483,POINT (-87.633087 41.650765),60827-20210301
60707,12/23/2020,15,71,15,71,0.002,0,0,0,43093,POINT (-87.808283 41.921777),60707-20201223
60645,01/03/2021,13,678,12,677,0.014,1,1,0,47270,POINT (-87.695049 42.008927),60645-20210103
60640,12/22/2020,135,606,135,606,0.009,0,0,0,69363,POINT (-87.662232 41.971888),60640-20201222
60661,12/22/2020,43,313,43,313,0.03,0,0,0,10354,POINT (-87.644283 41.882786),60661-20201222
60605,12/24/2020,42,1208,42,1208,0.042,0,0,0,29060,POINT (-87.623449 41.867824),60605-20201224
60652,12/19/2020,11,51,11,51,0.001,0,0,0,43447,POINT (-87.714238 41.745398),60652-20201219
60619,12/29/2020,48,201,48,201,0.003,0,0,0,61207,POINT (-87.60569 41.744737),60619-20201229
60633,01/17/2021,0,137,0,112,0.009,0,25,0.002,12689,POINT (-87.556037 41.653147),60633-20210117
60618,12/23/2020,114,880,114,880,0.009,0,0,0,94907,POINT (-87.703343 41.946699),60618-20201223
60609,01/06/2021,133,545,127,536,0.009,6,9,0,60939,POINT (-87.653382 41.812017),60609-20210106
60652,01/20/2021,75,1043,44,829,0.019,31,214,0.005,43447,POINT (-87.714238 41.745398),60652-20210120
60656,12/20/2020,12,117,12,117,0.004,0,0,0,28218,POINT (-87.817934 41.974566),60656-20201220
60607,01/30/2021,87,5397,57,3660,0.125,30,1737,0.059,29293,POINT (-87.652727 41.876104),60607-20210130
60624,01/18/2021,5,441,5,386,0.011,0,55,0.002,34892,POINT (-87.722735 41.879417),60624-20210118
60649,12/30/2020,23,297,23,297,0.006,0,0,0,46633,POINT (-87.571522 41.762202),60649-20201230
60607,01/01/2021,1,1413,1,1413,0.048,0,0,0,29293,POINT (-87.652727 41.876104),60607-20210101
60611,01/10/2021,48,3867,12,2906,0.087,36,961,0.029,33224,POINT (-87.620291 41.894734),60611-20210110
60626,01/12/2021,211,1730,175,1477,0.029,36,253,0.005,50544,POINT (-87.669834 42.009469),60626-20210112
60647,12/21/2020,146,680,146,680,0.008,0,0,0,87633,POINT (-87.701101 41.921058),60647-20201221
60622,01/23/2021,98,5976,93,4284,0.08,5,1692,0.032,53294,POINT (-87.681818 41.902762),60622-20210123
60629,12/31/2020,27,523,27,523,0.005,0,0,0,110029,POINT (-87.711565 41.777061),60629-20201231
60602,01/12/2021,9,94,2,67,0.059,7,27,0.024,1145,POINT (-87.628309 41.883136),60602-20210112
60651,01/17/2021,4,739,4,636,0.01,0,103,0.002,63492,POINT (-87.741017 41.901964),60651-20210117
60602,01/27/2021,11,245,8,190,0.166,3,55,0.048,1145,POINT (-87.628309 41.883136),60602-20210127
60613,12/16/2020,7,7,7,7,0,0,0,0,50761,POINT (-87.661343 41.953742),60613-20201216
60631,01/13/2021,86,1377,64,1064,0.036,22,313,0.011,29529,POINT (-87.813371 41.995019),60631-20210113
60614,12/21/2020,272,952,272,952,0.013,0,0,0,71954,POINT (-87.652064 41.922605),60614-20201221
60605,01/20/2021,128,3873,42,2437,0.084,86,1436,0.049,29060,POINT (-87.623449 41.867824),60605-20210120
60646,12/18/2020,90,103,90,103,0.004,0,0,0,28569,POINT (-87.761826 41.993931),60646-20201218
60608,01/12/2021,187,2035,97,1615,0.02,90,420,0.005,80059,POINT (-87.670366 41.849879),60608-20210112
60628,12/21/2020,20,64,20,64,0.001,0,0,0,64254,POINT (-87.621537 41.694192),60628-20201221
60655,01/07/2021,119,897,30,782,0.027,89,115,0.004,28569,POINT (-87.701434 41.696456),60655-20210107
60626,12/25/2020,0,337,0,337,0.007,0,0,0,50544,POINT (-87.669834 42.009469),60626-20201225
60645,12/29/2020,131,452,131,452,0.01,0,0,0,47270,POINT (-87.695049 42.008927),60645-20201229
60602,12/21/2020,5,20,5,20,0.017,0,0,0,1145,POINT (-87.628309 41.883136),60602-20201221
60645,01/08/2021,127,1279,61,1162,0.025,66,117,0.002,47270,POINT (-87.695049 42.008927),60645-20210108
60613,01/14/2021,133,3115,108,2336,0.046,25,779,0.015,50761,POINT (-87.661343 41.953742),60613-20210114
60621,01/05/2021,17,205,15,203,0.007,2,2,0,28018,POINT (-87.638812 41.776931),60621-20210105
60605,01/25/2021,154,4540,86,2952,0.102,68,1588,0.055,29060,POINT (-87.623449 41.867824),60605-20210125
60649,01/11/2021,83,701,69,635,0.014,14,66,0.001,46633,POINT (-87.571522 41.762202),60649-20210111
60628,01/29/2021,217,2141,199,1873,0.029,18,268,0.004,64254,POINT (-87.621537 41.694192),60628-20210129
60643,01/16/2021,61,1602,57,1294,0.026,4,308,0.006,48887,POINT (-87.662381 41.700445),60643-20210116
60827,01/16/2021,2,35,2,30,0.001,0,5,0,28483,POINT (-87.633087 41.650765),60827-20210116
60616,12/28/2020,55,715,55,715,0.013,0,0,0,54197,POINT (-87.629531 41.844869),60616-20201228
60617,01/19/2021,127,1320,94,1074,0.013,33,246,0.003,83553,POINT (-87.556897 41.721257),60617-20210119
60613,01/29/2021,262,5851,230,4418,0.087,32,1433,0.028,50761,POINT (-87.661343 41.953742),60613-20210129
Unknown,02/11/2021,93,1495,19,1044,0,74,451,0,0,,Unknown-20210211
60653,01/11/2021,34,710,13,605,0.018,21,105,0.003,33154,POINT (-87.611244 41.819261),60653-20210111
60607,12/27/2020,0,1010,0,1010,0.034,0,0,0,29293,POINT (-87.652727 41.876104),60607-20201227
60646,01/19/2021,76,1438,63,1099,0.038,13,339,0.012,28569,POINT (-87.761826 41.993931),60646-20210119
60641,12/15/2020,0,0,0,0,0,0,0,0,69880,POINT (-87.746791 41.946682),60641-20201215
60656,12/23/2020,14,192,14,192,0.007,0,0,0,28218,POINT (-87.817934 41.974566),60656-20201223
60628,01/14/2021,31,715,26,613,0.01,5,102,0.002,64254,POINT (-87.621537 41.694192),60628-20210114
60606,12/22/2020,15,84,15,84,0.026,0,0,0,3287,POINT (-87.63676 41.882634),60606-20201222
60632,01/11/2021,46,743,22,663,0.007,24,80,0.001,89857,POINT (-87.711251 41.810038),60632-20210111
60633,01/03/2021,1,54,1,54,0.004,0,0,0,12689,POINT (-87.556037 41.653147),60633-20210103
60642,01/10/2021,30,1227,9,924,0.047,21,303,0.015,19716,POINT (-87.657821 41.899935),60642-20210110
60660,01/02/2021,15,605,15,605,0.014,0,0,0,44498,POINT (-87.666362 41.991062),60660-20210102
60616,01/29/2021,257,4606,235,3508,0.065,22,1098,0.02,54197,POINT (-87.629531 41.844869),60616-20210129
60633,02/18/2021,37,995,20,771,0.061,17,224,0.018,12689,POINT (-87.556037 41.653147),60633-20210218
60657,01/15/2021,180,5101,154,3685,0.052,26,1416,0.02,70958,POINT (-87.658216 41.939715),60657-20210115
60639,01/09/2021,47,805,20,711,0.008,27,94,0.001,88204,POINT (-87.75531 41.920609),60639-20210109
60610,01/16/2021,68,2331,57,1671,0.041,11,660,0.016,40548,POINT (-87.63581 41.90455),60610-20210116
60625,01/08/2021,235,1984,87,1750,0.022,148,234,0.003,79444,POINT (-87.701816 41.971155),60625-20210108
60631,01/03/2021,9,642,9,642,0.022,0,0,0,29529,POINT (-87.813371 41.995019),60631-20210103
60609,12/25/2020,0,180,0,180,0.003,0,0,0,60939,POINT (-87.653382 41.812017),60609-20201225
60612,01/03/2021,10,815,10,815,0.024,0,0,0,33735,POINT (-87.687011 41.88004),60612-20210103
60630,12/21/2020,102,331,102,331,0.006,0,0,0,56433,POINT (-87.759611 41.971261),60630-20201221
60613,01/04/2021,89,1347,80,1338,0.026,9,9,0,50761,POINT (-87.661343 41.953742),60613-20210104
60652,01/03/2021,11,405,11,405,0.009,0,0,0,43447,POINT (-87.714238 41.745398),60652-20210103
60612,12/23/2020,76,488,76,488,0.014,0,0,0,33735,POINT (-87.687011 41.88004),60612-20201223
60625,12/29/2020,67,771,67,771,0.01,0,0,0,79444,POINT (-87.701816 41.971155),60625-20201229
60624,12/17/2020,8,9,8,9,0,0,0,0,34892,POINT (-87.722735 41.879417),60624-20201217
60606,02/16/2021,18,784,14,543,0.165,4,241,0.073,3287,POINT (-87.63676 41.882634),60606-20210216
60633,12/21/2020,4,14,4,14,0.001,0,0,0,12689,POINT (-87.556037 41.653147),60633-20201221
60641,12/30/2020,78,643,78,643,0.009,0,0,0,69880,POINT (-87.746791 41.946682),60641-20201230
60632,01/15/2021,55,1006,51,862,0.01,4,144,0.002,89857,POINT (-87.711251 41.810038),60632-20210115
60629,01/15/2021,61,1389,55,1133,0.01,6,256,0.002,110029,POINT (-87.711565 41.777061),60629-20210115
60606,12/21/2020,17,69,17,69,0.021,0,0,0,3287,POINT (-87.63676 41.882634),60606-20201221
60661,01/01/2021,0,461,0,461,0.045,0,0,0,10354,POINT (-87.644283 41.882786),60661-20210101
60652,12/25/2020,0,155,0,155,0.004,0,0,0,43447,POINT (-87.714238 41.745398),60652-20201225
60602,12/26/2020,0,30,0,30,0.026,0,0,0,1145,POINT (-87.628309 41.883136),60602-20201226
60618,01/09/2021,198,2600,77,2138,0.023,121,462,0.005,94907,POINT (-87.703343 41.946699),60618-20210109
60609,01/20/2021,97,1274,69,1015,0.017,28,259,0.004,60939,POINT (-87.653382 41.812017),60609-20210120
60646,12/22/2020,30,255,30,255,0.009,0,0,0,28569,POINT (-87.761826 41.993931),60646-20201222
60653,12/27/2020,0,169,0,169,0.005,0,0,0,33154,POINT (-87.611244 41.819261),60653-20201227
60827,12/27/2020,0,7,0,7,0,0,0,0,28483,POINT (-87.633087 41.650765),60827-20201227
60644,01/29/2021,106,1745,94,1512,0.032,12,233,0.005,46591,POINT (-87.756863 41.881113),60644-20210129
60639,12/16/2020,3,3,3,3,0,0,0,0,88204,POINT (-87.75531 41.920609),60639-20201216
60606,01/05/2021,7,146,4,140,0.043,3,6,0.002,3287,POINT (-87.63676 41.882634),60606-20210105
60618,01/03/2021,39,1499,36,1496,0.016,3,3,0,94907,POINT (-87.703343 41.946699),60618-20210103
60631,01/08/2021,183,1086,112,934,0.032,71,152,0.005,29529,POINT (-87.813371 41.995019),60631-20210108
60619,01/13/2021,87,693,71,596,0.01,16,97,0.002,61207,POINT (-87.60569 41.744737),60619-20210113
60602,01/22/2021,22,197,22,153,0.134,0,44,0.038,1145,POINT (-87.628309 41.883136),60602-20210122
60638,01/04/2021,45,621,41,617,0.011,4,4,0,58669,POINT (-87.771902 41.787032),60638-20210104
60619,12/16/2020,0,0,0,0,0,0,0,0,61207,POINT (-87.60569 41.744737),60619-20201216
60644,01/12/2021,38,735,32,691,0.015,6,44,0.001,46591,POINT (-87.756863 41.881113),60644-20210112
Unknown,01/25/2021,12,704,8,614,0,4,90,0,0,,Unknown-20210125
60606,01/22/2021,18,362,17,242,0.074,1,120,0.037,3287,POINT (-87.63676 41.882634),60606-20210122
60616,01/15/2021,74,2419,65,1786,0.033,9,633,0.012,54197,POINT (-87.629531 41.844869),60616-20210115
60641,01/02/2021,26,699,26,699,0.01,0,0,0,69880,POINT (-87.746791 41.946682),60641-20210102
60641,12/16/2020,18,18,18,18,0,0,0,0,69880,POINT (-87.746791 41.946682),60641-20201216
60601,12/16/2020,2,2,2,2,0,0,0,0,15083,POINT (-87.622844 41.886262),60601-20201216
60626,01/09/2021,65,1413,31,1254,0.025,34,159,0.003,50544,POINT (-87.669834 42.009469),60626-20210109
60636,12/27/2020,0,33,0,33,0.001,0,0,0,30024,POINT (-87.668597 41.77599),60636-20201227
60827,02/17/2021,8,161,4,123,0.004,4,38,0.001,28483,POINT (-87.633087 41.650765),60827-20210217
60651,12/15/2020,0,0,0,0,0,0,0,0,63492,POINT (-87.741017 41.901964),60651-20201215
60666,12/26/2020,0,0,0,0,0,0,0,0,0,POINT (-87.896371 41.979511),60666-20201226
60651,01/02/2021,13,250,13,250,0.004,0,0,0,63492,POINT (-87.741017 41.901964),60651-20210102
60644,12/28/2020,58,143,58,143,0.003,0,0,0,46591,POINT (-87.756863 41.881113),60644-20201228
60655,12/21/2020,76,299,76,299,0.01,0,0,0,28569,POINT (-87.701434 41.696456),60655-20201221
Unknown,01/10/2021,1,152,0,143,0,1,9,0,0,,Unknown-20210110
60607,01/23/2021,59,4240,50,2904,0.099,9,1336,0.046,29293,POINT (-87.652727 41.876104),60607-20210123
60605,12/15/2020,0,0,0,0,0,0,0,0,29060,POINT (-87.623449 41.867824),60605-20201215
60630,01/05/2021,154,912,152,908,0.016,2,4,0,56433,POINT (-87.759611 41.971261),60630-20210105
60707,01/13/2021,25,278,12,221,0.005,13,57,0.001,43093,POINT (-87.808283 41.921777),60707-20210113
60607,01/28/2021,239,5149,152,3491,0.119,87,1658,0.057,29293,POINT (-87.652727 41.876104),60607-20210128
60707,01/21/2021,45,520,39,417,0.01,6,103,0.002,43093,POINT (-87.808283 41.921777),60707-20210121
60649,12/15/2020,0,0,0,0,0,0,0,0,46633,POINT (-87.571522 41.762202),60649-20201215
60638,01/16/2021,38,1389,28,1062,0.018,10,327,0.006,58669,POINT (-87.771902 41.787032),60638-20210116
60621,12/19/2020,6,15,6,15,0.001,0,0,0,28018,POINT (-87.638812 41.776931),60621-20201219
60646,01/08/2021,99,799,23,678,0.024,76,121,0.004,28569,POINT (-87.761826 41.993931),60646-20210108
60641,01/31/2021,58,4143,46,3287,0.047,12,856,0.012,69880,POINT (-87.746791 41.946682),60641-20210131
60647,12/18/2020,242,337,242,337,0.004,0,0,0,87633,POINT (-87.701101 41.921058),60647-20201218
60647,01/02/2021,47,1392,47,1392,0.016,0,0,0,87633,POINT (-87.701101 41.921058),60647-20210102
60622,12/28/2020,63,1441,63,1441,0.027,0,0,0,53294,POINT (-87.681818 41.902762),60622-20201228
60647,01/11/2021,187,2627,55,1966,0.022,132,661,0.008,87633,POINT (-87.701101 41.921058),60647-20210111
60657,12/24/2020,50,1450,50,1450,0.02,0,0,0,70958,POINT (-87.658216 41.939715),60657-20201224
60657,01/10/2021,155,3849,107,3035,0.043,48,814,0.011,70958,POINT (-87.658216 41.939715),60657-20210110
60643,01/15/2021,67,1541,60,1237,0.025,7,304,0.006,48887,POINT (-87.662381 41.700445),60643-20210115
60644,01/15/2021,24,947,19,876,0.019,5,71,0.002,46591,POINT (-87.756863 41.881113),60644-20210115
60616,01/20/2021,152,2848,92,2030,0.037,60,818,0.015,54197,POINT (-87.629531 41.844869),60616-20210120
60606,02/15/2021,13,766,7,529,0.161,6,237,0.072,3287,POINT (-87.63676 41.882634),60606-20210215
60601,12/21/2020,73,221,73,221,0.015,0,0,0,15083,POINT (-87.622844 41.886262),60601-20201221
Unknown,12/17/2020,4,4,4,4,0,0,0,0,0,,Unknown-20201217
60602,01/23/2021,10,207,10,163,0.142,0,44,0.038,1145,POINT (-87.628309 41.883136),60602-20210123
60660,12/19/2020,53,176,53,176,0.004,0,0,0,44498,POINT (-87.666362 41.991062),60660-20201219
60613,12/21/2020,157,561,157,561,0.011,0,0,0,50761,POINT (-87.661343 41.953742),60613-20201221
60606,02/02/2021,14,529,11,377,0.115,3,152,0.046,3287,POINT (-87.63676 41.882634),60606-20210202
60661,01/17/2021,6,1064,4,722,0.07,2,342,0.033,10354,POINT (-87.644283 41.882786),60661-20210117
60651,12/18/2020,28,33,28,33,0.001,0,0,0,63492,POINT (-87.741017 41.901964),60651-20201218
60640,01/08/2021,501,2624,360,2373,0.034,141,251,0.004,69363,POINT (-87.662232 41.971888),60640-20210108
60645,01/09/2021,39,1318,17,1179,0.025,22,139,0.003,47270,POINT (-87.695049 42.008927),60645-20210109
60630,01/04/2021,72,758,70,756,0.013,2,2,0,56433,POINT (-87.759611 41.971261),60630-20210104
60645,01/11/2021,73,1406,29,1216,0.026,44,190,0.004,47270,POINT (-87.695049 42.008927),60645-20210111
60633,02/08/2021,23,650,18,545,0.043,5,105,0.008,12689,POINT (-87.556037 41.653147),60633-20210208
60666,01/23/2021,0,2,0,2,0,0,0,0,0,POINT (-87.896371 41.979511),60666-20210123
Unknown,01/11/2021,7,159,3,146,0,4,13,0,0,,Unknown-20210111
60611,01/14/2021,103,4827,66,3210,0.097,37,1617,0.049,33224,POINT (-87.620291 41.894734),60611-20210114
60649,01/05/2021,33,378,31,374,0.008,2,4,0,46633,POINT (-87.571522 41.762202),60649-20210105
60827,02/18/2021,6,167,1,124,0.004,5,43,0.002,28483,POINT (-87.633087 41.650765),60827-20210218
60636,12/15/2020,0,0,0,0,0,0,0,0,30024,POINT (-87.668597 41.77599),60636-20201215
60619,01/18/2021,50,958,38,832,0.014,12,126,0.002,61207,POINT (-87.60569 41.744737),60619-20210118
60609,01/21/2021,128,1402,106,1121,0.018,22,281,0.005,60939,POINT (-87.653382 41.812017),60609-20210121
60608,12/15/2020,0,0,0,0,0,0,0,0,80059,POINT (-87.670366 41.849879),60608-20201215
60611,12/28/2020,127,1781,127,1781,0.054,0,0,0,33224,POINT (-87.620291 41.894734),60611-20201228
60656,12/21/2020,45,162,45,162,0.006,0,0,0,28218,POINT (-87.817934 41.974566),60656-20201221
60707,01/18/2021,13,338,9,269,0.006,4,69,0.002,43093,POINT (-87.808283 41.921777),60707-20210118
60602,12/22/2020,4,24,4,24,0.021,0,0,0,1145,POINT (-87.628309 41.883136),60602-20201222
60827,12/22/2020,2,6,2,6,0,0,0,0,28483,POINT (-87.633087 41.650765),60827-20201222
60616,01/13/2021,173,2261,121,1665,0.031,52,596,0.011,54197,POINT (-87.629531 41.844869),60616-20210113
60651,01/31/2021,13,1974,12,1668,0.026,1,306,0.005,63492,POINT (-87.741017 41.901964),60651-20210131
60632,01/08/2021,48,653,34,614,0.007,14,39,0,89857,POINT (-87.711251 41.810038),60632-20210108
60629,12/27/2020,1,287,1,287,0.003,0,0,0,110029,POINT (-87.711565 41.777061),60629-20201227
60618,12/27/2020,0,943,0,943,0.01,0,0,0,94907,POINT (-87.703343 41.946699),60618-20201227
60827,01/17/2021,0,35,0,30,0.001,0,5,0,28483,POINT (-87.633087 41.650765),60827-20210117
60657,01/04/2021,187,2353,178,2343,0.033,9,10,0,70958,POINT (-87.658216 41.939715),60657-20210104
60628,01/03/2021,6,241,5,240,0.004,1,1,0,64254,POINT (-87.621537 41.694192),60628-20210103
60631,01/29/2021,150,2920,130,2367,0.08,20,553,0.019,29529,POINT (-87.813371 41.995019),60631-20210129
60625,01/27/2021,366,5221,269,4038,0.051,97,1183,0.015,79444,POINT (-87.701816 41.971155),60625-20210127
60656,01/01/2021,0,285,0,285,0.01,0,0,0,28218,POINT (-87.817934 41.974566),60656-20210101
60632,01/26/2021,153,2028,118,1685,0.019,35,343,0.004,89857,POINT (-87.711251 41.810038),60632-20210126
60645,01/26/2021,492,3224,375,2642,0.056,117,582,0.012,47270,POINT (-87.695049 42.008927),60645-20210126
60666,12/17/2020,0,0,0,0,0,0,0,0,0,POINT (-87.896371 41.979511),60666-20201217
60638,12/22/2020,53,277,53,277,0.005,0,0,0,58669,POINT (-87.771902 41.787032),60638-20201222
60653,01/07/2021,42,531,27,503,0.015,15,28,0.001,33154,POINT (-87.611244 41.819261),60653-20210107
60631,01/18/2021,36,1649,30,1308,0.044,6,341,0.012,29529,POINT (-87.813371 41.995019),60631-20210118
60827,02/05/2021,6,114,5,95,0.003,1,19,0.001,28483,POINT (-87.633087 41.650765),60827-20210205
60642,12/27/2020,0,523,0,523,0.027,0,0,0,19716,POINT (-87.657821 41.899935),60642-20201227
60602,01/08/2021,10,74,3,64,0.056,7,10,0.009,1145,POINT (-87.628309 41.883136),60602-20210108
60623,01/04/2021,50,464,49,463,0.006,1,1,0,81283,POINT (-87.717446 41.850321),60623-20210104
60661,01/06/2021,28,565,17,548,0.053,11,17,0.002,10354,POINT (-87.644283 41.882786),60661-20210106
60637,12/23/2020,68,324,68,324,0.007,0,0,0,47300,POINT (-87.604053 41.780991),60637-20201223
60657,12/18/2020,352,494,352,494,0.007,0,0,0,70958,POINT (-87.658216 41.939715),60657-20201218
60640,01/03/2021,98,1327,98,1327,0.019,0,0,0,69363,POINT (-87.662232 41.971888),60640-20210103
60610,12/27/2020,0,659,0,659,0.016,0,0,0,40548,POINT (-87.63581 41.90455),60610-20201227
60628,01/17/2021,4,775,1,668,0.01,3,107,0.002,64254,POINT (-87.621537 41.694192),60628-20210117
60636,12/30/2020,19,75,19,75,0.002,0,0,0,30024,POINT (-87.668597 41.77599),60636-20201230
60610,01/28/2021,293,4401,254,3303,0.081,39,1098,0.027,40548,POINT (-87.63581 41.90455),60610-20210128
60636,01/11/2021,7,181,6,166,0.006,1,15,0,30024,POINT (-87.668597 41.77599),60636-20210111
60649,01/24/2021,35,1773,34,1579,0.034,1,194,0.004,46633,POINT (-87.571522 41.762202),60649-20210124
60625,01/12/2021,177,2465,122,1986,0.025,55,479,0.006,79444,POINT (-87.701816 41.971155),60625-20210112
60623,12/29/2020,50,302,50,302,0.004,0,0,0,81283,POINT (-87.717446 41.850321),60623-20201229
60611,01/02/2021,33,2051,33,2051,0.062,0,0,0,33224,POINT (-87.620291 41.894734),60611-20210102
60652,12/28/2020,98,255,98,255,0.006,0,0,0,43447,POINT (-87.714238 41.745398),60652-20201228
60617,01/10/2021,6,693,1,611,0.007,5,82,0.001,83553,POINT (-87.556897 41.721257),60617-20210110
60633,01/07/2021,15,90,6,80,0.006,9,10,0.001,12689,POINT (-87.556037 41.653147),60633-20210107
60637,01/05/2021,49,829,33,802,0.017,16,27,0.001,47300,POINT (-87.604053 41.780991),60637-20210105
60605,01/06/2021,87,1902,43,1806,0.062,44,96,0.003,29060,POINT (-87.623449 41.867824),60605-20210106
60631,12/17/2020,20,23,20,23,0.001,0,0,0,29529,POINT (-87.813371 41.995019),60631-20201217
60623,12/22/2020,26,113,26,113,0.001,0,0,0,81283,POINT (-87.717446 41.850321),60623-20201222
60613,01/05/2021,142,1489,135,1473,0.029,7,16,0,50761,POINT (-87.661343 41.953742),60613-20210105
60707,01/04/2021,7,133,6,132,0.003,1,1,0,43093,POINT (-87.808283 41.921777),60707-20210104
60633,12/25/2020,0,26,0,26,0.002,0,0,0,12689,POINT (-87.556037 41.653147),60633-20201225
60638,12/18/2020,73,95,73,95,0.002,0,0,0,58669,POINT (-87.771902 41.787032),60638-20201218
60618,01/01/2021,3,1415,3,1415,0.015,0,0,0,94907,POINT (-87.703343 41.946699),60618-20210101
60636,01/06/2021,15,128,14,126,0.004,1,2,0,30024,POINT (-87.668597 41.77599),60636-20210106
60616,01/31/2021,29,4802,26,3678,0.068,3,1124,0.021,54197,POINT (-87.629531 41.844869),60616-20210131
60656,01/22/2021,58,1032,56,786,0.028,2,246,0.009,28218,POINT (-87.817934 41.974566),60656-20210122
60660,01/24/2021,24,3077,23,2570,0.058,1,507,0.011,44498,POINT (-87.666362 41.991062),60660-20210124
60614,12/22/2020,201,1153,201,1153,0.016,0,0,0,71954,POINT (-87.652064 41.922605),60614-20201222
60651,12/30/2020,49,219,49,219,0.003,0,0,0,63492,POINT (-87.741017 41.901964),60651-20201230
60622,01/22/2021,235,5878,190,4191,0.079,45,1687,0.032,53294,POINT (-87.681818 41.902762),60622-20210122
60629,01/11/2021,72,1022,27,860,0.008,45,162,0.001,110029,POINT (-87.711565 41.777061),60629-20210111
60613,12/31/2020,34,1206,34,1206,0.024,0,0,0,50761,POINT (-87.661343 41.953742),60613-20201231
60629,01/25/2021,150,2528,122,2079,0.019,28,449,0.004,110029,POINT (-87.711565 41.777061),60629-20210125
60666,01/13/2021,1,1,1,1,0,0,0,0,0,POINT (-87.896371 41.979511),60666-20210113
60618,01/13/2021,204,3300,109,2464,0.026,95,836,0.009,94907,POINT (-87.703343 41.946699),60618-20210113
60621,01/04/2021,8,188,8,188,0.007,0,0,0,28018,POINT (-87.638812 41.776931),60621-20210104
60631,12/30/2020,48,455,48,455,0.015,0,0,0,29529,POINT (-87.813371 41.995019),60631-20201230
60617,12/22/2020,41,157,41,157,0.002,0,0,0,83553,POINT (-87.556897 41.721257),60617-20201222
60666,12/22/2020,0,0,0,0,0,0,0,0,0,POINT (-87.896371 41.979511),60666-20201222
60666,02/19/2021,1,26,0,23,0,1,3,0,0,POINT (-87.896371 41.979511),60666-20210219
60612,12/19/2020,52,209,52,209,0.006,0,0,0,33735,POINT (-87.687011 41.88004),60612-20201219
60605,01/21/2021,171,4044,122,2559,0.088,49,1485,0.051,29060,POINT (-87.623449 41.867824),60605-20210121
Unknown,12/22/2020,5,27,5,27,0,0,0,0,0,,Unknown-20201222
60621,12/25/2020,0,33,0,33,0.001,0,0,0,28018,POINT (-87.638812 41.776931),60621-20201225
60616,12/19/2020,81,304,81,304,0.006,0,0,0,54197,POINT (-87.629531 41.844869),60616-20201219
60601,01/12/2021,73,857,27,601,0.04,46,256,0.017,15083,POINT (-87.622844 41.886262),60601-20210112
60601,01/22/2021,120,1366,109,974,0.065,11,392,0.026,15083,POINT (-87.622844 41.886262),60601-20210122
60620,01/04/2021,34,305,30,300,0.004,4,5,0,67711,POINT (-87.651656 41.740873),60620-20210104
60623,01/19/2021,76,1267,45,1079,0.013,31,188,0.002,81283,POINT (-87.717446 41.850321),60623-20210119
60608,12/30/2020,141,845,141,845,0.011,0,0,0,80059,POINT (-87.670366 41.849879),60608-20201230
60622,01/12/2021,274,4092,111,2967,0.056,163,1125,0.021,53294,POINT (-87.681818 41.902762),60622-20210112
60606,12/17/2020,7,7,7,7,0.002,0,0,0,3287,POINT (-87.63676 41.882634),60606-20201217
60620,12/20/2020,3,69,3,69,0.001,0,0,0,67711,POINT (-87.651656 41.740873),60620-20201220
60651,01/06/2021,28,371,25,366,0.006,3,5,0,63492,POINT (-87.741017 41.901964),60651-20210106
60636,01/16/2021,7,246,6,218,0.007,1,28,0.001,30024,POINT (-87.668597 41.77599),60636-20210116
60629,01/28/2021,244,3197,203,2623,0.024,41,574,0.005,110029,POINT (-87.711565 41.777061),60629-20210128
60641,12/20/2020,15,215,15,215,0.003,0,0,0,69880,POINT (-87.746791 41.946682),60641-20201220
60653,12/23/2020,27,160,27,160,0.005,0,0,0,33154,POINT (-87.611244 41.819261),60653-20201223
60656,12/26/2020,3,197,3,197,0.007,0,0,0,28218,POINT (-87.817934 41.974566),60656-20201226
60606,01/18/2021,7,287,2,192,0.058,5,95,0.029,3287,POINT (-87.63676 41.882634),60606-20210118
60644,01/25/2021,128,1404,73,1220,0.026,55,184,0.004,46591,POINT (-87.756863 41.881113),60644-20210125
60642,01/11/2021,77,1304,21,945,0.048,56,359,0.018,19716,POINT (-87.657821 41.899935),60642-20210111
60644,01/19/2021,26,1017,9,918,0.02,17,99,0.002,46591,POINT (-87.756863 41.881113),60644-20210119
60606,01/01/2021,0,123,0,123,0.037,0,0,0,3287,POINT (-87.63676 41.882634),60606-20210101
60646,01/01/2021,1,461,1,461,0.016,0,0,0,28569,POINT (-87.761826 41.993931),60646-20210101
60609,12/21/2020,31,103,31,103,0.002,0,0,0,60939,POINT (-87.653382 41.812017),60609-20201221
60643,01/18/2021,64,1676,52,1352,0.028,12,324,0.007,48887,POINT (-87.662381 41.700445),60643-20210118
60606,01/23/2021,13,375,11,253,0.077,2,122,0.037,3287,POINT (-87.63676 41.882634),60606-20210123
60707,12/18/2020,15,17,15,17,0,0,0,0,43093,POINT (-87.808283 41.921777),60707-20201218
60643,12/29/2020,44,375,44,375,0.008,0,0,0,48887,POINT (-87.662381 41.700445),60643-20201229
60624,01/14/2021,60,393,59,343,0.01,1,50,0.001,34892,POINT (-87.722735 41.879417),60624-20210114
60611,12/23/2020,67,1589,67,1589,0.048,0,0,0,33224,POINT (-87.620291 41.894734),60611-20201223
60601,01/05/2021,36,499,34,495,0.033,2,4,0,15083,POINT (-87.622844 41.886262),60601-20210105
60641,01/06/2021,89,992,60,963,0.014,29,29,0,69880,POINT (-87.746791 41.946682),60641-20210106
60649,12/19/2020,7,48,7,48,0.001,0,0,0,46633,POINT (-87.571522 41.762202),60649-20201219
60628,12/19/2020,10,38,10,38,0.001,0,0,0,64254,POINT (-87.621537 41.694192),60628-20201219
60656,01/27/2021,107,1312,88,1009,0.036,19,303,0.011,28218,POINT (-87.817934 41.974566),60656-20210127
60611,01/19/2021,163,5406,65,3478,0.105,98,1928,0.058,33224,POINT (-87.620291 41.894734),60611-20210119
60629,01/10/2021,17,950,4,833,0.008,13,117,0.001,110029,POINT (-87.711565 41.777061),60629-20210110
Unknown,02/12/2021,42,1537,19,1063,0,23,474,0,0,,Unknown-20210212
60640,12/19/2020,96,314,96,314,0.005,0,0,0,69363,POINT (-87.662232 41.971888),60640-20201219
60610,01/11/2021,137,1840,33,1356,0.033,104,484,0.012,40548,POINT (-87.63581 41.90455),60610-20210111
60644,12/24/2020,4,82,4,82,0.002,0,0,0,46591,POINT (-87.756863 41.881113),60644-20201224
60601,01/17/2021,13,1015,7,706,0.047,6,309,0.02,15083,POINT (-87.622844 41.886262),60601-20210117
60652,12/31/2020,20,382,20,382,0.009,0,0,0,43447,POINT (-87.714238 41.745398),60652-20201231
60645,12/25/2020,0,284,0,284,0.006,0,0,0,47270,POINT (-87.695049 42.008927),60645-20201225
60625,12/26/2020,16,643,16,643,0.008,0,0,0,79444,POINT (-87.701816 41.971155),60625-20201226
60621,12/15/2020,0,0,0,0,0,0,0,0,28018,POINT (-87.638812 41.776931),60621-20201215
60645,12/21/2020,52,199,52,199,0.004,0,0,0,47270,POINT (-87.695049 42.008927),60645-20201221
60602,12/29/2020,5,39,5,39,0.034,0,0,0,1145,POINT (-87.628309 41.883136),60602-20201229
60619,01/03/2021,6,280,6,280,0.005,0,0,0,61207,POINT (-87.60569 41.744737),60619-20210103
60645,01/15/2021,75,1807,70,1539,0.033,5,268,0.006,47270,POINT (-87.695049 42.008927),60645-20210115
60638,01/12/2021,95,1120,44,857,0.015,51,263,0.004,58669,POINT (-87.771902 41.787032),60638-20210112
60633,01/11/2021,7,106,2,90,0.007,5,16,0.001,12689,POINT (-87.556037 41.653147),60633-20210111
60661,12/20/2020,17,214,17,214,0.021,0,0,0,10354,POINT (-87.644283 41.882786),60661-20201220
60633,02/12/2021,49,850,32,688,0.054,17,162,0.013,12689,POINT (-87.556037 41.653147),60633-20210212
60633,01/30/2021,24,415,20,342,0.027,4,73,0.006,12689,POINT (-87.556037 41.653147),60633-20210130
60624,01/27/2021,78,818,62,675,0.019,16,143,0.004,34892,POINT (-87.722735 41.879417),60624-20210127
60626,01/02/2021,13,761,13,761,0.015,0,0,0,50544,POINT (-87.669834 42.009469),60626-20210102
60608,01/04/2021,97,1033,91,1027,0.013,6,6,0,80059,POINT (-87.670366 41.849879),60608-20210104
60607,12/31/2020,61,1412,61,1412,0.048,0,0,0,29293,POINT (-87.652727 41.876104),60607-20201231
60656,12/17/2020,9,10,9,10,0,0,0,0,28218,POINT (-87.817934 41.974566),60656-20201217
60651,01/14/2021,40,664,37,568,0.009,3,96,0.002,63492,POINT (-87.741017 41.901964),60651-20210114
60637,01/02/2021,7,626,7,626,0.013,0,0,0,47300,POINT (-87.604053 41.780991),60637-20210102
Unknown,12/21/2020,12,22,12,22,0,0,0,0,0,,Unknown-20201221
60609,12/16/2020,0,0,0,0,0,0,0,0,60939,POINT (-87.653382 41.812017),60609-20201216
60827,02/14/2021,0,148,0,119,0.004,0,29,0.001,28483,POINT (-87.633087 41.650765),60827-20210214
60633,12/30/2020,8,45,8,45,0.004,0,0,0,12689,POINT (-87.556037 41.653147),60633-20201230
60644,12/15/2020,0,0,0,0,0,0,0,0,46591,POINT (-87.756863 41.881113),60644-20201215
60612,01/05/2021,51,946,49,943,0.028,2,3,0,33735,POINT (-87.687011 41.88004),60612-20210105
60617,02/01/2021,125,3742,113,3243,0.039,12,499,0.006,83553,POINT (-87.556897 41.721257),60617-20210201
60637,12/26/2020,4,363,4,363,0.008,0,0,0,47300,POINT (-87.604053 41.780991),60637-20201226
60625,12/31/2020,85,991,85,991,0.012,0,0,0,79444,POINT (-87.701816 41.971155),60625-20201231
60628,01/24/2021,31,1351,31,1160,0.018,0,191,0.003,64254,POINT (-87.621537 41.694192),60628-20210124
60639,01/02/2021,27,405,27,405,0.005,0,0,0,88204,POINT (-87.75531 41.920609),60639-20210102
60636,01/19/2021,23,284,18,246,0.008,5,38,0.001,30024,POINT (-87.668597 41.77599),60636-20210119
60606,01/29/2021,26,484,22,345,0.105,4,139,0.042,3287,POINT (-87.63676 41.882634),60606-20210129
60639,12/27/2020,0,217,0,217,0.002,0,0,0,88204,POINT (-87.75531 41.920609),60639-20201227
60645,01/05/2021,121,956,120,952,0.02,1,4,0,47270,POINT (-87.695049 42.008927),60645-20210105
60643,01/01/2021,0,458,0,458,0.009,0,0,0,48887,POINT (-87.662381 41.700445),60643-20210101
60645,01/22/2021,120,2419,111,2021,0.043,9,398,0.008,47270,POINT (-87.695049 42.008927),60645-20210122
60642,01/07/2021,90,947,24,859,0.044,66,88,0.004,19716,POINT (-87.657821 41.899935),60642-20210107
60653,12/21/2020,31,101,31,101,0.003,0,0,0,33154,POINT (-87.611244 41.819261),60653-20201221
60602,01/03/2021,3,47,3,47,0.041,0,0,0,1145,POINT (-87.628309 41.883136),60602-20210103
60605,01/01/2021,2,1549,2,1549,0.053,0,0,0,29060,POINT (-87.623449 41.867824),60605-20210101
60616,12/23/2020,76,616,76,616,0.011,0,0,0,54197,POINT (-87.629531 41.844869),60616-20201223
60666,01/01/2021,0,0,0,0,0,0,0,0,0,POINT (-87.896371 41.979511),60666-20210101
60626,12/16/2020,1,1,1,1,0,0,0,0,50544,POINT (-87.669834 42.009469),60626-20201216
60609,01/25/2021,104,1729,85,1419,0.023,19,310,0.005,60939,POINT (-87.653382 41.812017),60609-20210125
60827,01/13/2021,3,27,3,23,0.001,0,4,0,28483,POINT (-87.633087 41.650765),60827-20210113
60651,12/27/2020,0,115,0,115,0.002,0,0,0,63492,POINT (-87.741017 41.901964),60651-20201227
60624,01/09/2021,11,245,8,222,0.006,3,23,0.001,34892,POINT (-87.722735 41.879417),60624-20210109
60661,01/21/2021,55,1227,34,799,0.077,21,428,0.041,10354,POINT (-87.644283 41.882786),60661-20210121
60630,12/31/2020,44,651,44,651,0.012,0,0,0,56433,POINT (-87.759611 41.971261),60630-20201231
60606,02/24/2021,26,940,10,601,0.183,16,339,0.103,3287,POINT (-87.63676 41.882634),60606-20210224
60616,01/24/2021,23,3408,21,2517,0.046,2,891,0.016,54197,POINT (-87.629531 41.844869),60616-20210124
60624,01/26/2021,45,740,31,613,0.018,14,127,0.004,34892,POINT (-87.722735 41.879417),60624-20210126
60643,01/08/2021,96,872,32,734,0.015,64,138,0.003,48887,POINT (-87.662381 41.700445),60643-20210108
60649,01/09/2021,18,613,11,563,0.012,7,50,0.001,46633,POINT (-87.571522 41.762202),60649-20210109
60649,01/20/2021,101,1367,83,1210,0.026,18,157,0.003,46633,POINT (-87.571522 41.762202),60649-20210120
60666,01/18/2021,0,1,0,1,0,0,0,0,0,POINT (-87.896371 41.979511),60666-20210118
60607,01/09/2021,170,2436,29,1919,0.066,141,517,0.018,29293,POINT (-87.652727 41.876104),60607-20210109
60622,01/02/2021,37,2130,37,2130,0.04,0,0,0,53294,POINT (-87.681818 41.902762),60622-20210102
60614,12/28/2020,102,1425,102,1425,0.02,0,0,0,71954,POINT (-87.652064 41.922605),60614-20201228
60630,01/13/2021,114,1687,71,1300,0.023,43,387,0.007,56433,POINT (-87.759611 41.971261),60630-20210113
60666,02/02/2021,2,12,2,12,0,0,0,0,0,POINT (-87.896371 41.979511),60666-20210202
60642,12/23/2020,53,498,53,498,0.025,0,0,0,19716,POINT (-87.657821 41.899935),60642-20201223
60632,12/20/2020,6,53,6,53,0.001,0,0,0,89857,POINT (-87.711251 41.810038),60632-20201220
60616,01/09/2021,101,1723,30,1380,0.025,71,343,0.006,54197,POINT (-87.629531 41.844869),60616-20210109
60630,01/11/2021,116,1466,37,1154,0.02,79,312,0.006,56433,POINT (-87.759611 41.971261),60630-20210111
60619,12/18/2020,27,34,27,34,0.001,0,0,0,61207,POINT (-87.60569 41.744737),60619-20201218
60632,12/19/2020,10,47,10,47,0.001,0,0,0,89857,POINT (-87.711251 41.810038),60632-20201219
60653,01/03/2021,11,411,11,411,0.012,0,0,0,33154,POINT (-87.611244 41.819261),60653-20210103
60608,12/20/2020,19,244,19,244,0.003,0,0,0,80059,POINT (-87.670366 41.849879),60608-20201220
60617,01/17/2021,5,1128,4,928,0.011,1,200,0.002,83553,POINT (-87.556897 41.721257),60617-20210117
60638,12/26/2020,5,327,5,327,0.006,0,0,0,58669,POINT (-87.771902 41.787032),60638-20201226
60707,12/30/2020,16,114,16,114,0.003,0,0,0,43093,POINT (-87.808283 41.921777),60707-20201230
60606,02/19/2021,25,863,7,574,0.175,18,289,0.088,3287,POINT (-87.63676 41.882634),60606-20210219
60652,12/16/2020,0,1,0,1,0,0,0,0,43447,POINT (-87.714238 41.745398),60652-20201216
60630,01/28/2021,216,3428,174,2667,0.047,42,761,0.013,56433,POINT (-87.759611 41.971261),60630-20210128
60629,12/21/2020,46,168,46,168,0.002,0,0,0,110029,POINT (-87.711565 41.777061),60629-20201221
60617,01/27/2021,291,2755,262,2324,0.028,29,431,0.005,83553,POINT (-87.556897 41.721257),60617-20210127
60613,01/22/2021,252,4323,226,3225,0.064,26,1098,0.022,50761,POINT (-87.661343 41.953742),60613-20210122
60610,12/23/2020,46,623,46,623,0.015,0,0,0,40548,POINT (-87.63581 41.90455),60610-20201223
60647,12/28/2020,59,1043,59,1043,0.012,0,0,0,87633,POINT (-87.701101 41.921058),60647-20201228
60625,01/22/2021,230,4162,211,3256,0.041,19,906,0.011,79444,POINT (-87.701816 41.971155),60625-20210122
60657,01/08/2021,455,3477,117,2868,0.04,338,609,0.009,70958,POINT (-87.658216 41.939715),60657-20210108
60623,01/08/2021,65,742,44,705,0.009,21,37,0,81283,POINT (-87.717446 41.850321),60623-20210108
60605,12/27/2020,2,1219,2,1219,0.042,0,0,0,29060,POINT (-87.623449 41.867824),60605-20201227
60621,12/28/2020,60,94,60,94,0.003,0,0,0,28018,POINT (-87.638812 41.776931),60621-20201228
60651,12/22/2020,17,86,17,86,0.001,0,0,0,63492,POINT (-87.741017 41.901964),60651-20201222
60661,01/10/2021,16,803,2,601,0.058,14,202,0.02,10354,POINT (-87.644283 41.882786),60661-20210110
60657,12/22/2020,205,1253,205,1253,0.018,0,0,0,70958,POINT (-87.658216 41.939715),60657-20201222
60637,12/16/2020,2,2,2,2,0,0,0,0,47300,POINT (-87.604053 41.780991),60637-20201216
60618,01/08/2021,295,2402,97,2061,0.022,198,341,0.004,94907,POINT (-87.703343 41.946699),60618-20210108
60652,01/17/2021,6,889,5,742,0.017,1,147,0.003,43447,POINT (-87.714238 41.745398),60652-20210117
60610,01/24/2021,42,3548,36,2672,0.066,6,876,0.022,40548,POINT (-87.63581 41.90455),60610-20210124
60631,01/22/2021,125,2106,111,1695,0.057,14,411,0.014,29529,POINT (-87.813371 41.995019),60631-20210122
60641,01/10/2021,19,1324,11,1106,0.016,8,218,0.003,69880,POINT (-87.746791 41.946682),60641-20210110
Unknown,02/19/2021,54,1801,23,1168,0,31,633,0,0,,Unknown-20210219
60655,12/24/2020,9,375,9,375,0.013,0,0,0,28569,POINT (-87.701434 41.696456),60655-20201224
60651,01/11/2021,34,520,21,460,0.007,13,60,0.001,63492,POINT (-87.741017 41.901964),60651-20210111
60612,12/31/2020,33,798,33,798,0.024,0,0,0,33735,POINT (-87.687011 41.88004),60612-20201231
60629,12/24/2020,16,277,16,277,0.003,0,0,0,110029,POINT (-87.711565 41.777061),60629-20201224
60623,01/30/2021,88,2884,73,2414,0.03,15,470,0.006,81283,POINT (-87.717446 41.850321),60623-20210130
60617,01/06/2021,56,526,50,515,0.006,6,11,0,83553,POINT (-87.556897 41.721257),60617-20210106
60617,12/26/2020,3,202,3,202,0.002,0,0,0,83553,POINT (-87.556897 41.721257),60617-20201226
60643,12/17/2020,27,28,27,28,0.001,0,0,0,48887,POINT (-87.662381 41.700445),60643-20201217
60605,12/20/2020,74,640,74,640,0.022,0,0,0,29060,POINT (-87.623449 41.867824),60605-20201220
60632,01/21/2021,133,1504,115,1239,0.014,18,265,0.003,89857,POINT (-87.711251 41.810038),60632-20210121
60609,01/10/2021,14,696,3,624,0.01,11,72,0.001,60939,POINT (-87.653382 41.812017),60609-20210110
60613,12/27/2020,0,823,0,823,0.016,0,0,0,50761,POINT (-87.661343 41.953742),60613-20201227
60624,12/15/2020,0,0,0,0,0,0,0,0,34892,POINT (-87.722735 41.879417),60624-20201215
60614,12/18/2020,321,454,321,454,0.006,0,0,0,71954,POINT (-87.652064 41.922605),60614-20201218
60626,12/18/2020,79,104,79,104,0.002,0,0,0,50544,POINT (-87.669834 42.009469),60626-20201218
60613,01/28/2021,276,5589,228,4188,0.083,48,1401,0.028,50761,POINT (-87.661343 41.953742),60613-20210128
60624,12/25/2020,0,58,0,58,0.002,0,0,0,34892,POINT (-87.722735 41.879417),60624-20201225
60626,01/04/2021,74,854,73,852,0.017,1,2,0,50544,POINT (-87.669834 42.009469),60626-20210104
60637,01/17/2021,18,1724,0,1285,0.027,18,439,0.009,47300,POINT (-87.604053 41.780991),60637-20210117
60640,12/24/2020,39,725,39,725,0.01,0,0,0,69363,POINT (-87.662232 41.971888),60640-20201224
60637,01/24/2021,48,2938,45,2264,0.048,3,674,0.014,47300,POINT (-87.604053 41.780991),60637-20210124
60618,12/17/2020,57,60,57,60,0.001,0,0,0,94907,POINT (-87.703343 41.946699),60618-20201217
60660,01/20/2021,112,2613,85,2174,0.049,27,439,0.01,44498,POINT (-87.666362 41.991062),60660-20210120
60632,01/03/2021,7,423,7,423,0.005,0,0,0,89857,POINT (-87.711251 41.810038),60632-20210103
60637,01/26/2021,149,3269,109,2510,0.053,40,759,0.016,47300,POINT (-87.604053 41.780991),60637-20210126
60641,12/24/2020,22,429,22,429,0.006,0,0,0,69880,POINT (-87.746791 41.946682),60641-20201224
60707,01/24/2021,2,599,1,493,0.011,1,106,0.002,43093,POINT (-87.808283 41.921777),60707-20210124
60636,12/18/2020,5,8,5,8,0,0,0,0,30024,POINT (-87.668597 41.77599),60636-20201218
60646,01/11/2021,65,926,14,708,0.025,51,218,0.008,28569,POINT (-87.761826 41.993931),60646-20210111
60644,01/04/2021,32,338,32,338,0.007,0,0,0,46591,POINT (-87.756863 41.881113),60644-20210104
60827,01/04/2021,2,11,2,11,0,0,0,0,28483,POINT (-87.633087 41.650765),60827-20210104
60666,02/14/2021,0,23,0,21,0,0,2,0,0,POINT (-87.896371 41.979511),60666-20210214
60610,01/07/2021,108,1295,29,1187,0.029,79,108,0.003,40548,POINT (-87.63581 41.90455),60610-20210107
60606,12/28/2020,5,97,5,97,0.03,0,0,0,3287,POINT (-87.63676 41.882634),60606-20201228
Unknown,01/18/2021,4,384,3,342,0,1,42,0,0,,Unknown-20210118
60620,12/31/2020,12,257,12,257,0.004,0,0,0,67711,POINT (-87.651656 41.740873),60620-20201231
60601,12/24/2020,9,308,9,308,0.02,0,0,0,15083,POINT (-87.622844 41.886262),60601-20201224
60827,12/16/2020,0,0,0,0,0,0,0,0,28483,POINT (-87.633087 41.650765),60827-20201216
60619,01/05/2021,36,349,34,345,0.006,2,4,0,61207,POINT (-87.60569 41.744737),60619-20210105
60622,01/18/2021,126,4882,78,3522,0.066,48,1360,0.026,53294,POINT (-87.681818 41.902762),60622-20210118
60660,01/05/2021,77,801,76,796,0.018,1,5,0,44498,POINT (-87.666362 41.991062),60660-20210105
60652,01/22/2021,77,1202,68,961,0.022,9,241,0.006,43447,POINT (-87.714238 41.745398),60652-20210122
60649,12/23/2020,26,107,26,107,0.002,0,0,0,46633,POINT (-87.571522 41.762202),60649-20201223
60656,01/18/2021,21,796,18,588,0.021,3,208,0.007,28218,POINT (-87.817934 41.974566),60656-20210118
60625,12/21/2020,130,433,130,433,0.005,0,0,0,79444,POINT (-87.701816 41.971155),60625-20201221
60646,01/16/2021,33,1292,30,987,0.035,3,305,0.011,28569,POINT (-87.761826 41.993931),60646-20210116
60623,12/18/2020,26,38,26,38,0,0,0,0,81283,POINT (-87.717446 41.850321),60623-20201218
60660,12/30/2020,116,557,116,557,0.013,0,0,0,44498,POINT (-87.666362 41.991062),60660-20201230
60605,01/28/2021,205,5044,161,3315,0.114,44,1729,0.059,29060,POINT (-87.623449 41.867824),60605-20210128
60651,01/28/2021,150,1703,125,1427,0.022,25,276,0.004,63492,POINT (-87.741017 41.901964),60651-20210128
60653,12/17/2020,10,10,10,10,0,0,0,0,33154,POINT (-87.611244 41.819261),60653-20201217
60642,01/20/2021,99,1863,47,1235,0.063,52,628,0.032,19716,POINT (-87.657821 41.899935),60642-20210120
60612,12/26/2020,4,527,4,527,0.016,0,0,0,33735,POINT (-87.687011 41.88004),60612-20201226
60655,12/31/2020,31,530,31,530,0.019,0,0,0,28569,POINT (-87.701434 41.696456),60655-20201231
60644,01/23/2021,33,1273,31,1144,0.025,2,129,0.003,46591,POINT (-87.756863 41.881113),60644-20210123
60623,01/23/2021,74,1776,72,1533,0.019,2,243,0.003,81283,POINT (-87.717446 41.850321),60623-20210123
60611,12/18/2020,515,702,515,702,0.021,0,0,0,33224,POINT (-87.620291 41.894734),60611-20201218
60606,01/14/2021,8,263,8,176,0.054,0,87,0.026,3287,POINT (-87.63676 41.882634),60606-20210114
60631,12/21/2020,74,281,74,281,0.01,0,0,0,29529,POINT (-87.813371 41.995019),60631-20201221
60707,02/25/2021,73,2350,32,1703,0.04,41,647,0.015,43093,POINT (-87.808283 41.921777),60707-20210225
60644,12/22/2020,9,56,9,56,0.001,0,0,0,46591,POINT (-87.756863 41.881113),60644-20201222
60607,01/15/2021,90,3238,76,2270,0.077,14,968,0.033,29293,POINT (-87.652727 41.876104),60607-20210115
60660,12/22/2020,45,288,45,288,0.006,0,0,0,44498,POINT (-87.666362 41.991062),60660-20201222
60641,01/21/2021,170,2548,138,1960,0.028,32,588,0.008,69880,POINT (-87.746791 41.946682),60641-20210121
60642,01/02/2021,11,710,11,710,0.036,0,0,0,19716,POINT (-87.657821 41.899935),60642-20210102
60642,01/29/2021,113,2588,90,1764,0.089,23,824,0.042,19716,POINT (-87.657821 41.899935),60642-20210129
60647,12/23/2020,103,935,103,935,0.011,0,0,0,87633,POINT (-87.701101 41.921058),60647-20201223
60602,01/15/2021,7,114,7,84,0.073,0,30,0.026,1145,POINT (-87.628309 41.883136),60602-20210115
60605,12/31/2020,40,1547,40,1547,0.053,0,0,0,29060,POINT (-87.623449 41.867824),60605-20201231
60621,12/22/2020,4,28,4,28,0.001,0,0,0,28018,POINT (-87.638812 41.776931),60621-20201222
60607,12/18/2020,244,349,244,349,0.012,0,0,0,29293,POINT (-87.652727 41.876104),60607-20201218
60661,12/16/2020,7,7,7,7,0.001,0,0,0,10354,POINT (-87.644283 41.882786),60661-20201216
60633,01/26/2021,27,293,20,234,0.018,7,59,0.005,12689,POINT (-87.556037 41.653147),60633-20210126
60620,12/26/2020,2,135,2,135,0.002,0,0,0,67711,POINT (-87.651656 41.740873),60620-20201226
60661,01/14/2021,33,1007,22,675,0.065,11,332,0.032,10354,POINT (-87.644283 41.882786),60661-20210114
60661,01/27/2021,43,1413,29,916,0.088,14,497,0.048,10354,POINT (-87.644283 41.882786),60661-20210127
Unknown,02/04/2021,67,1140,34,914,0,33,226,0,0,,Unknown-20210204
60618,12/18/2020,217,277,217,277,0.003,0,0,0,94907,POINT (-87.703343 41.946699),60618-20201218
60643,01/05/2021,38,552,32,545,0.011,6,7,0,48887,POINT (-87.662381 41.700445),60643-20210105
60645,01/19/2021,82,1995,54,1679,0.036,28,316,0.007,47270,POINT (-87.695049 42.008927),60645-20210119
60614,12/29/2020,188,1613,188,1613,0.022,0,0,0,71954,POINT (-87.652064 41.922605),60614-20201229
60661,12/26/2020,8,359,8,359,0.035,0,0,0,10354,POINT (-87.644283 41.882786),60661-20201226
60641,01/20/2021,179,2378,124,1822,0.026,55,556,0.008,69880,POINT (-87.746791 41.946682),60641-20210120
60643,01/07/2021,74,776,27,702,0.014,47,74,0.002,48887,POINT (-87.662381 41.700445),60643-20210107
60607,01/04/2021,159,1611,150,1601,0.055,9,10,0,29293,POINT (-87.652727 41.876104),60607-20210104
60602,01/30/2021,14,282,12,224,0.196,2,58,0.051,1145,POINT (-87.628309 41.883136),60602-20210130
60626,12/29/2020,59,422,59,422,0.008,0,0,0,50544,POINT (-87.669834 42.009469),60626-20201229
60622,01/05/2021,137,2389,129,2367,0.044,8,22,0,53294,POINT (-87.681818 41.902762),60622-20210105
60655,01/06/2021,54,778,34,752,0.026,20,26,0.001,28569,POINT (-87.701434 41.696456),60655-20210106
60827,02/11/2021,4,139,3,114,0.004,1,25,0.001,28483,POINT (-87.633087 41.650765),60827-20210211
60605,01/11/2021,228,2878,41,1997,0.069,187,881,0.03,29060,POINT (-87.623449 41.867824),60605-20210111
60617,01/28/2021,306,3061,284,2608,0.031,22,453,0.005,83553,POINT (-87.556897 41.721257),60617-20210128
60651,01/18/2021,42,781,23,659,0.01,19,122,0.002,63492,POINT (-87.741017 41.901964),60651-20210118
60608,12/23/2020,76,532,76,532,0.007,0,0,0,80059,POINT (-87.670366 41.849879),60608-20201223
60644,12/27/2020,0,85,0,85,0.002,0,0,0,46591,POINT (-87.756863 41.881113),60644-20201227
60639,01/06/2021,60,607,54,596,0.007,6,11,0,88204,POINT (-87.75531 41.920609),60639-20210106
60616,12/27/2020,0,660,0,660,0.012,0,0,0,54197,POINT (-87.629531 41.844869),60616-20201227
60623,01/07/2021,50,677,40,661,0.008,10,16,0,81283,POINT (-87.717446 41.850321),60623-20210107
60666,02/10/2021,2,22,1,20,0,1,2,0,0,POINT (-87.896371 41.979511),60666-20210210
60609,01/29/2021,232,2405,209,1994,0.033,23,411,0.007,60939,POINT (-87.653382 41.812017),60609-20210129
60666,01/05/2021,0,0,0,0,0,0,0,0,0,POINT (-87.896371 41.979511),60666-20210105
60651,12/23/2020,20,106,20,106,0.002,0,0,0,63492,POINT (-87.741017 41.901964),60651-20201223
60616,01/28/2021,332,4349,281,3273,0.06,51,1076,0.02,54197,POINT (-87.629531 41.844869),60616-20210128
60641,01/30/2021,168,4085,140,3241,0.046,28,844,0.012,69880,POINT (-87.746791 41.946682),60641-20210130
60633,12/16/2020,0,0,0,0,0,0,0,0,12689,POINT (-87.556037 41.653147),60633-20201216
60636,01/23/2021,12,464,12,403,0.013,0,61,0.002,30024,POINT (-87.668597 41.77599),60636-20210123
60607,12/23/2020,108,954,108,954,0.033,0,0,0,29293,POINT (-87.652727 41.876104),60607-20201223
60666,02/06/2021,0,14,0,14,0,0,0,0,0,POINT (-87.896371 41.979511),60666-20210206
60661,01/09/2021,66,787,7,599,0.058,59,188,0.018,10354,POINT (-87.644283 41.882786),60661-20210109
60619,01/04/2021,33,313,31,311,0.005,2,2,0,61207,POINT (-87.60569 41.744737),60619-20210104
60647,12/24/2020,36,971,36,971,0.011,0,0,0,87633,POINT (-87.701101 41.921058),60647-20201224
60633,01/21/2021,17,204,15,165,0.013,2,39,0.003,12689,POINT (-87.556037 41.653147),60633-20210121
60827,01/05/2021,0,11,0,11,0,0,0,0,28483,POINT (-87.633087 41.650765),60827-20210105
60609,01/02/2021,5,341,5,341,0.006,0,0,0,60939,POINT (-87.653382 41.812017),60609-20210102
60619,12/25/2020,0,121,0,121,0.002,0,0,0,61207,POINT (-87.60569 41.744737),60619-20201225
60628,01/09/2021,20,557,16,510,0.008,4,47,0.001,64254,POINT (-87.621537 41.694192),60628-20210109
60630,12/27/2020,0,435,0,435,0.008,0,0,0,56433,POINT (-87.759611 41.971261),60630-20201227
60666,01/22/2021,0,2,0,2,0,0,0,0,0,POINT (-87.896371 41.979511),60666-20210122
60609,12/28/2020,24,206,24,206,0.003,0,0,0,60939,POINT (-87.653382 41.812017),60609-20201228
60607,01/05/2021,86,1697,74,1675,0.057,12,22,0.001,29293,POINT (-87.652727 41.876104),60607-20210105
60624,12/31/2020,16,118,16,118,0.003,0,0,0,34892,POINT (-87.722735 41.879417),60624-20201231
Unknown,01/30/2021,25,953,16,816,0,9,137,0,0,,Unknown-20210130
60632,12/24/2020,11,154,11,154,0.002,0,0,0,89857,POINT (-87.711251 41.810038),60632-20201224
60629,12/17/2020,17,19,17,19,0,0,0,0,110029,POINT (-87.711565 41.777061),60629-20201217
60628,12/25/2020,0,111,0,111,0.002,0,0,0,64254,POINT (-87.621537 41.694192),60628-20201225
60624,01/15/2021,29,422,26,369,0.011,3,53,0.002,34892,POINT (-87.722735 41.879417),60624-20210115
60625,01/01/2021,1,992,1,992,0.012,0,0,0,79444,POINT (-87.701816 41.971155),60625-20210101
60614,12/17/2020,129,133,129,133,0.002,0,0,0,71954,POINT (-87.652064 41.922605),60614-20201217
60616,01/21/2021,194,3042,160,2190,0.04,34,852,0.016,54197,POINT (-87.629531 41.844869),60616-20210121
60633,02/07/2021,9,627,9,527,0.042,0,100,0.008,12689,POINT (-87.556037 41.653147),60633-20210207
60652,12/20/2020,12,63,12,63,0.001,0,0,0,43447,POINT (-87.714238 41.745398),60652-20201220
60641,12/29/2020,79,565,79,565,0.008,0,0,0,69880,POINT (-87.746791 41.946682),60641-20201229
60613,01/18/2021,133,3478,68,2588,0.051,65,890,0.018,50761,POINT (-87.661343 41.953742),60613-20210118
60666,03/01/2021,0,33,0,23,0,0,10,0,0,POINT (-87.896371 41.979511),60666-20210301
60637,12/29/2020,73,450,73,450,0.01,0,0,0,47300,POINT (-87.604053 41.780991),60637-20201229
60707,12/26/2020,0,75,0,75,0.002,0,0,0,43093,POINT (-87.808283 41.921777),60707-20201226
60622,12/21/2020,263,1015,263,1015,0.019,0,0,0,53294,POINT (-87.681818 41.902762),60622-20201221
Unknown,01/03/2021,2,90,2,90,0,0,0,0,0,,Unknown-20210103
60645,01/02/2021,15,665,15,665,0.014,0,0,0,47270,POINT (-87.695049 42.008927),60645-20210102
60608,12/16/2020,0,0,0,0,0,0,0,0,80059,POINT (-87.670366 41.849879),60608-20201216
60623,01/12/2021,108,944,84,848,0.01,24,96,0.001,81283,POINT (-87.717446 41.850321),60623-20210112
60610,12/19/2020,98,323,98,323,0.008,0,0,0,40548,POINT (-87.63581 41.90455),60610-20201219
60827,12/21/2020,0,4,0,4,0,0,0,0,28483,POINT (-87.633087 41.650765),60827-20201221
60602,01/02/2021,0,44,0,44,0.038,0,0,0,1145,POINT (-87.628309 41.883136),60602-20210102
60619,12/30/2020,43,244,43,244,0.004,0,0,0,61207,POINT (-87.60569 41.744737),60619-20201230
60644,01/28/2021,90,1639,79,1418,0.03,11,221,0.005,46591,POINT (-87.756863 41.881113),60644-20210128
60652,01/21/2021,82,1125,64,893,0.021,18,232,0.005,43447,POINT (-87.714238 41.745398),60652-20210121
60641,12/19/2020,56,200,56,200,0.003,0,0,0,69880,POINT (-87.746791 41.946682),60641-20201219
60631,01/07/2021,98,903,37,822,0.028,61,81,0.003,29529,POINT (-87.813371 41.995019),60631-20210107
60606,12/18/2020,29,36,29,36,0.011,0,0,0,3287,POINT (-87.63676 41.882634),60606-20201218
60617,02/02/2021,208,3950,156,3399,0.041,52,551,0.007,83553,POINT (-87.556897 41.721257),60617-20210202
60609,01/07/2021,52,597,36,572,0.009,16,25,0,60939,POINT (-87.653382 41.812017),60609-20210107
60649,01/15/2021,41,1003,33,891,0.019,8,112,0.002,46633,POINT (-87.571522 41.762202),60649-20210115
60617,12/30/2020,52,343,52,343,0.004,0,0,0,83553,POINT (-87.556897 41.721257),60617-20201230
60637,01/13/2021,79,1409,50,1085,0.023,29,324,0.007,47300,POINT (-87.604053 41.780991),60637-20210113
60651,01/07/2021,29,400,23,389,0.006,6,11,0,63492,POINT (-87.741017 41.901964),60651-20210107
60607,01/31/2021,24,5421,17,3677,0.126,7,1744,0.06,29293,POINT (-87.652727 41.876104),60607-20210131
60633,01/16/2021,4,137,2,112,0.009,2,25,0.002,12689,POINT (-87.556037 41.653147),60633-20210116
60610,01/20/2021,178,2751,130,1936,0.048,48,815,0.02,40548,POINT (-87.63581 41.90455),60610-20210120
60613,02/02/2021,275,6504,158,4860,0.096,117,1644,0.032,50761,POINT (-87.661343 41.953742),60613-20210202
60629,01/03/2021,20,560,20,560,0.005,0,0,0,110029,POINT (-87.711565 41.777061),60629-20210103
60617,12/16/2020,1,1,1,1,0,0,0,0,83553,POINT (-87.556897 41.721257),60617-20201216
60666,12/31/2020,0,0,0,0,0,0,0,0,0,POINT (-87.896371 41.979511),60666-20201231
60643,12/21/2020,61,215,61,215,0.004,0,0,0,48887,POINT (-87.662381 41.700445),60643-20201221
60631,01/26/2021,102,2430,75,1956,0.066,27,474,0.016,29529,POINT (-87.813371 41.995019),60631-20210126
60639,01/12/2021,110,1078,76,917,0.01,34,161,0.002,88204,POINT (-87.75531 41.920609),60639-20210112
60626,01/08/2021,153,1348,73,1223,0.024,80,125,0.002,50544,POINT (-87.669834 42.009469),60626-20210108
60606,02/20/2021,10,873,1,575,0.175,9,298,0.091,3287,POINT (-87.63676 41.882634),60606-20210220
60613,02/01/2021,171,6229,115,4702,0.093,56,1527,0.03,50761,POINT (-87.661343 41.953742),60613-20210201
60642,01/01/2021,0,699,0,699,0.035,0,0,0,19716,POINT (-87.657821 41.899935),60642-20210101
60617,01/02/2021,5,368,5,368,0.004,0,0,0,83553,POINT (-87.556897 41.721257),60617-20210102
60646,12/15/2020,0,0,0,0,0,0,0,0,28569,POINT (-87.761826 41.993931),60646-20201215
60629,01/31/2021,25,3734,19,3097,0.028,6,637,0.006,110029,POINT (-87.711565 41.777061),60629-20210131
60632,01/31/2021,20,3043,20,2558,0.028,0,485,0.005,89857,POINT (-87.711251 41.810038),60632-20210131
60640,12/29/2020,104,930,104,930,0.013,0,0,0,69363,POINT (-87.662232 41.971888),60640-20201229
60622,01/14/2021,210,4519,172,3238,0.061,38,1281,0.024,53294,POINT (-87.681818 41.902762),60622-20210114
60609,01/14/2021,43,932,39,763,0.013,4,169,0.003,60939,POINT (-87.653382 41.812017),60609-20210114
60624,01/21/2021,56,579,44,486,0.014,12,93,0.003,34892,POINT (-87.722735 41.879417),60624-20210121
60653,01/10/2021,13,676,3,592,0.018,10,84,0.003,33154,POINT (-87.611244 41.819261),60653-20210110
60636,01/08/2021,23,166,17,155,0.005,6,11,0,30024,POINT (-87.668597 41.77599),60636-20210108
60633,02/22/2021,28,1106,19,823,0.065,9,283,0.022,12689,POINT (-87.556037 41.653147),60633-20210222
60649,01/14/2021,48,962,41,858,0.018,7,104,0.002,46633,POINT (-87.571522 41.762202),60649-20210114
60657,12/27/2020,1,1501,1,1501,0.021,0,0,0,70958,POINT (-87.658216 41.939715),60657-20201227
60632,12/30/2020,131,373,131,373,0.004,0,0,0,89857,POINT (-87.711251 41.810038),60632-20201230
60707,01/20/2021,42,475,28,378,0.009,14,97,0.002,43093,POINT (-87.808283 41.921777),60707-20210120
60616,01/06/2021,73,1254,44,1203,0.022,29,51,0.001,54197,POINT (-87.629531 41.844869),60616-20210106
60660,01/16/2021,64,2316,58,1980,0.044,6,336,0.008,44498,POINT (-87.666362 41.991062),60660-20210116
60636,12/22/2020,4,21,4,21,0.001,0,0,0,30024,POINT (-87.668597 41.77599),60636-20201222
60633,01/31/2021,2,417,2,344,0.027,0,73,0.006,12689,POINT (-87.556037 41.653147),60633-20210131
60660,01/09/2021,59,1786,26,1598,0.036,33,188,0.004,44498,POINT (-87.666362 41.991062),60660-20210109
60646,01/20/2021,119,1557,88,1187,0.042,31,370,0.013,28569,POINT (-87.761826 41.993931),60646-20210120
60644,01/08/2021,37,661,25,638,0.014,12,23,0,46591,POINT (-87.756863 41.881113),60644-20210108
60827,12/31/2020,0,9,0,9,0,0,0,0,28483,POINT (-87.633087 41.650765),60827-20201231
60633,02/17/2021,47,958,25,751,0.059,22,207,0.016,12689,POINT (-87.556037 41.653147),60633-20210217
60610,01/03/2021,10,946,9,945,0.023,1,1,0,40548,POINT (-87.63581 41.90455),60610-20210103
60637,01/29/2021,143,3690,130,2858,0.06,13,832,0.018,47300,POINT (-87.604053 41.780991),60637-20210129
60624,12/20/2020,1,24,1,24,0.001,0,0,0,34892,POINT (-87.722735 41.879417),60624-20201220
60601,12/28/2020,22,340,22,340,0.023,0,0,0,15083,POINT (-87.622844 41.886262),60601-20201228
60626,01/13/2021,98,1828,58,1535,0.03,40,293,0.006,50544,POINT (-87.669834 42.009469),60626-20210113
60660,01/31/2021,59,4196,36,3411,0.077,23,785,0.018,44498,POINT (-87.666362 41.991062),60660-20210131
60638,01/20/2021,127,1689,85,1270,0.022,42,419,0.007,58669,POINT (-87.771902 41.787032),60638-20210120
60660,01/03/2021,27,632,27,632,0.014,0,0,0,44498,POINT (-87.666362 41.991062),60660-20210103
60639,12/20/2020,5,90,5,90,0.001,0,0,0,88204,POINT (-87.75531 41.920609),60639-20201220
60651,01/24/2021,7,1227,6,1034,0.016,1,193,0.003,63492,POINT (-87.741017 41.901964),60651-20210124
60625,12/17/2020,33,37,33,37,0,0,0,0,79444,POINT (-87.701816 41.971155),60625-20201217
60653,12/31/2020,9,399,9,399,0.012,0,0,0,33154,POINT (-87.611244 41.819261),60653-20201231
60608,01/07/2021,111,1284,64,1214,0.015,47,70,0.001,80059,POINT (-87.670366 41.849879),60608-20210107
60619,01/09/2021,25,507,18,460,0.008,7,47,0.001,61207,POINT (-87.60569 41.744737),60619-20210109
60652,01/10/2021,12,621,3,560,0.013,9,61,0.001,43447,POINT (-87.714238 41.745398),60652-20210110
60628,01/08/2021,67,537,42,494,0.008,25,43,0.001,64254,POINT (-87.621537 41.694192),60628-20210108
60642,01/06/2021,36,857,25,835,0.042,11,22,0.001,19716,POINT (-87.657821 41.899935),60642-20210106
60623,12/19/2020,12,50,12,50,0.001,0,0,0,81283,POINT (-87.717446 41.850321),60623-20201219
60601,01/25/2021,59,1466,36,1049,0.07,23,417,0.028,15083,POINT (-87.622844 41.886262),60601-20210125
60629,01/18/2021,48,1575,30,1288,0.012,18,287,0.003,110029,POINT (-87.711565 41.777061),60629-20210118
60642,01/16/2021,39,1642,31,1130,0.057,8,512,0.026,19716,POINT (-87.657821 41.899935),60642-20210116
60638,01/10/2021,20,961,6,791,0.013,14,170,0.003,58669,POINT (-87.771902 41.787032),60638-20210110
60655,01/04/2021,18,688,17,687,0.024,1,1,0,28569,POINT (-87.701434 41.696456),60655-20210104
60631,12/25/2020,0,341,0,341,0.012,0,0,0,29529,POINT (-87.813371 41.995019),60631-20201225
60666,02/01/2021,1,10,1,10,0,0,0,0,0,POINT (-87.896371 41.979511),60666-20210201
60646,12/25/2020,0,309,0,309,0.011,0,0,0,28569,POINT (-87.761826 41.993931),60646-20201225
60641,01/25/2021,175,3060,137,2409,0.034,38,651,0.009,69880,POINT (-87.746791 41.946682),60641-20210125
60647,01/06/2021,103,1717,75,1673,0.019,28,44,0.001,87633,POINT (-87.701101 41.921058),60647-20210106
60642,01/25/2021,78,2185,47,1488,0.075,31,697,0.035,19716,POINT (-87.657821 41.899935),60642-20210125
60657,12/28/2020,119,1620,119,1620,0.023,0,0,0,70958,POINT (-87.658216 41.939715),60657-20201228
60644,12/18/2020,14,18,14,18,0,0,0,0,46591,POINT (-87.756863 41.881113),60644-20201218
60607,01/19/2021,151,3542,60,2422,0.083,91,1120,0.038,29293,POINT (-87.652727 41.876104),60607-20210119
60657,01/14/2021,158,4921,110,3531,0.05,48,1390,0.02,70958,POINT (-87.658216 41.939715),60657-20210114
60660,12/26/2020,5,347,5,347,0.008,0,0,0,44498,POINT (-87.666362 41.991062),60660-20201226
60623,01/27/2021,265,2334,175,1946,0.024,90,388,0.005,81283,POINT (-87.717446 41.850321),60623-20210127
60632,01/14/2021,70,951,60,811,0.009,10,140,0.002,89857,POINT (-87.711251 41.810038),60632-20210114
60644,01/01/2021,0,213,0,213,0.005,0,0,0,46591,POINT (-87.756863 41.881113),60644-20210101
60643,01/11/2021,82,1015,44,794,0.016,38,221,0.005,48887,POINT (-87.662381 41.700445),60643-20210111
60618,12/22/2020,137,766,137,766,0.008,0,0,0,94907,POINT (-87.703343 41.946699),60618-20201222
60653,12/26/2020,0,169,0,169,0.005,0,0,0,33154,POINT (-87.611244 41.819261),60653-20201226
60827,12/26/2020,0,7,0,7,0,0,0,0,28483,POINT (-87.633087 41.650765),60827-20201226
60638,01/03/2021,9,576,9,576,0.01,0,0,0,58669,POINT (-87.771902 41.787032),60638-20210103
60619,01/14/2021,139,832,131,727,0.012,8,105,0.002,61207,POINT (-87.60569 41.744737),60619-20210114
60655,12/18/2020,90,131,90,131,0.005,0,0,0,28569,POINT (-87.701434 41.696456),60655-20201218
60611,01/09/2021,213,3819,51,2894,0.087,162,925,0.028,33224,POINT (-87.620291 41.894734),60611-20210109
60605,01/15/2021,86,3450,62,2256,0.078,24,1194,0.041,29060,POINT (-87.623449 41.867824),60605-20210115
60657,01/09/2021,217,3694,60,2928,0.041,157,766,0.011,70958,POINT (-87.658216 41.939715),60657-20210109
60638,01/15/2021,55,1351,45,1034,0.018,10,317,0.005,58669,POINT (-87.771902 41.787032),60638-20210115
60602,01/11/2021,5,85,0,65,0.057,5,20,0.017,1145,POINT (-87.628309 41.883136),60602-20210111
60616,01/16/2021,56,2475,36,1822,0.034,20,653,0.012,54197,POINT (-87.629531 41.844869),60616-20210116
60611,12/27/2020,0,1654,0,1654,0.05,0,0,0,33224,POINT (-87.620291 41.894734),60611-20201227
60601,12/17/2020,29,31,29,31,0.002,0,0,0,15083,POINT (-87.622844 41.886262),60601-20201217
60630,01/03/2021,7,686,7,686,0.012,0,0,0,56433,POINT (-87.759611 41.971261),60630-20210103
60624,01/04/2021,22,148,22,148,0.004,0,0,0,34892,POINT (-87.722735 41.879417),60624-20210104
60613,12/17/2020,49,56,49,56,0.001,0,0,0,50761,POINT (-87.661343 41.953742),60613-20201217
Unknown,01/26/2021,47,751,33,647,0,14,104,0,0,,Unknown-20210126
60644,01/11/2021,15,697,7,659,0.014,8,38,0.001,46591,POINT (-87.756863 41.881113),60644-20210111
60609,12/24/2020,7,180,7,180,0.003,0,0,0,60939,POINT (-87.653382 41.812017),60609-20201224
60651,01/20/2021,99,920,63,744,0.012,36,176,0.003,63492,POINT (-87.741017 41.901964),60651-20210120
Unknown,01/07/2021,10,130,8,128,0,2,2,0,0,,Unknown-20210107
60827,01/27/2021,5,62,4,54,0.002,1,8,0,28483,POINT (-87.633087 41.650765),60827-20210127
60630,01/08/2021,147,1258,61,1089,0.019,86,169,0.003,56433,POINT (-87.759611 41.971261),60630-20210108
60628,12/30/2020,37,215,37,215,0.003,0,0,0,64254,POINT (-87.621537 41.694192),60628-20201230
60607,01/24/2021,18,4258,16,2920,0.1,2,1338,0.046,29293,POINT (-87.652727 41.876104),60607-20210124
60645,12/18/2020,65,87,65,87,0.002,0,0,0,47270,POINT (-87.695049 42.008927),60645-20201218
60660,12/15/2020,0,0,0,0,0,0,0,0,44498,POINT (-87.666362 41.991062),60660-20201215
60656,01/05/2021,26,366,26,366,0.013,0,0,0,28218,POINT (-87.817934 41.974566),60656-20210105
60645,01/29/2021,174,3862,146,3097,0.066,28,765,0.016,47270,POINT (-87.695049 42.008927),60645-20210129
60707,01/14/2021,21,299,15,236,0.005,6,63,0.001,43093,POINT (-87.808283 41.921777),60707-20210114
60621,12/18/2020,4,9,4,9,0,0,0,0,28018,POINT (-87.638812 41.776931),60621-20201218
60609,01/17/2021,10,1060,4,872,0.014,6,188,0.003,60939,POINT (-87.653382 41.812017),60609-20210117
60628,01/13/2021,55,684,34,587,0.009,21,97,0.002,64254,POINT (-87.621537 41.694192),60628-20210113
60645,01/14/2021,77,1732,66,1469,0.031,11,263,0.006,47270,POINT (-87.695049 42.008927),60645-20210114
60651,12/19/2020,13,46,13,46,0.001,0,0,0,63492,POINT (-87.741017 41.901964),60651-20201219
60638,01/02/2021,28,567,28,567,0.01,0,0,0,58669,POINT (-87.771902 41.787032),60638-20210102
60616,12/15/2020,0,0,0,0,0,0,0,0,54197,POINT (-87.629531 41.844869),60616-20201215
60617,01/22/2021,233,1973,212,1649,0.02,21,324,0.004,83553,POINT (-87.556897 41.721257),60617-20210122
60606,12/23/2020,4,88,4,88,0.027,0,0,0,3287,POINT (-87.63676 41.882634),60606-20201223
60632,01/12/2021,77,820,47,710,0.008,30,110,0.001,89857,POINT (-87.711251 41.810038),60632-20210112
60608,12/27/2020,0,571,0,571,0.007,0,0,0,80059,POINT (-87.670366 41.849879),60608-20201227
60616,01/01/2021,2,920,2,920,0.017,0,0,0,54197,POINT (-87.629531 41.844869),60616-20210101
60640,01/13/2021,329,3649,233,2977,0.043,96,672,0.01,69363,POINT (-87.662232 41.971888),60640-20210113
60633,01/06/2021,7,75,6,74,0.006,1,1,0,12689,POINT (-87.556037 41.653147),60633-20210106
60707,12/17/2020,1,2,1,2,0,0,0,0,43093,POINT (-87.808283 41.921777),60707-20201217
60622,01/09/2021,250,3455,52,2744,0.051,198,711,0.013,53294,POINT (-87.681818 41.902762),60622-20210109
60625,01/07/2021,137,1749,71,1663,0.021,66,86,0.001,79444,POINT (-87.701816 41.971155),60625-20210107
60629,01/22/2021,188,2273,178,1859,0.017,10,414,0.004,110029,POINT (-87.711565 41.777061),60629-20210122
60656,01/10/2021,13,547,6,423,0.015,7,124,0.004,28218,POINT (-87.817934 41.974566),60656-20210110
60630,01/21/2021,165,2399,131,1834,0.032,34,565,0.01,56433,POINT (-87.759611 41.971261),60630-20210121
60641,01/15/2021,97,1908,85,1497,0.021,12,411,0.006,69880,POINT (-87.746791 41.946682),60641-20210115
60614,12/27/2020,2,1323,2,1323,0.018,0,0,0,71954,POINT (-87.652064 41.922605),60614-20201227
60630,12/20/2020,19,229,19,229,0.004,0,0,0,56433,POINT (-87.759611 41.971261),60630-20201220
60613,01/01/2021,0,1206,0,1206,0.024,0,0,0,50761,POINT (-87.661343 41.953742),60613-20210101
60637,12/25/2020,0,359,0,359,0.008,0,0,0,47300,POINT (-87.604053 41.780991),60637-20201225
60616,12/30/2020,92,883,92,883,0.016,0,0,0,54197,POINT (-87.629531 41.844869),60616-20201230
60611,12/29/2020,120,1901,120,1901,0.057,0,0,0,33224,POINT (-87.620291 41.894734),60611-20201229
60652,12/24/2020,9,155,9,155,0.004,0,0,0,43447,POINT (-87.714238 41.745398),60652-20201224
60661,01/02/2021,10,471,10,471,0.045,0,0,0,10354,POINT (-87.644283 41.882786),60661-20210102
60633,12/20/2020,1,10,1,10,0.001,0,0,0,12689,POINT (-87.556037 41.653147),60633-20201220
60609,01/22/2021,116,1518,113,1234,0.02,3,284,0.005,60939,POINT (-87.653382 41.812017),60609-20210122
60610,12/31/2020,24,900,24,900,0.022,0,0,0,40548,POINT (-87.63581 41.90455),60610-20201231
60623,12/31/2020,38,394,38,394,0.005,0,0,0,81283,POINT (-87.717446 41.850321),60623-20201231
60827,02/01/2021,1,85,0,72,0.003,1,13,0,28483,POINT (-87.633087 41.650765),60827-20210201
60640,01/07/2021,160,2123,87,2013,0.029,73,110,0.002,69363,POINT (-87.662232 41.971888),60640-20210107
60827,01/10/2021,0,19,0,17,0.001,0,2,0,28483,POINT (-87.633087 41.650765),60827-20210110
60629,12/30/2020,95,496,95,496,0.005,0,0,0,110029,POINT (-87.711565 41.777061),60629-20201230
60607,01/29/2021,161,5310,112,3603,0.123,49,1707,0.058,29293,POINT (-87.652727 41.876104),60607-20210129
60617,01/14/2021,63,976,52,791,0.009,11,185,0.002,83553,POINT (-87.556897 41.721257),60617-20210114
60637,01/09/2021,78,1187,24,1000,0.021,54,187,0.004,47300,POINT (-87.604053 41.780991),60637-20210109
60613,01/13/2021,176,2982,91,2228,0.044,85,754,0.015,50761,POINT (-87.661343 41.953742),60613-20210113
60622,01/26/2021,253,6430,137,4554,0.085,116,1876,0.035,53294,POINT (-87.681818 41.902762),60622-20210126
60622,12/25/2020,0,1362,0,1362,0.026,0,0,0,53294,POINT (-87.681818 41.902762),60622-20201225
60606,01/06/2021,4,150,1,141,0.043,3,9,0.003,3287,POINT (-87.63676 41.882634),60606-20210106
60625,01/18/2021,120,3124,81,2458,0.031,39,666,0.008,79444,POINT (-87.701816 41.971155),60625-20210118
60652,01/25/2021,178,1432,74,1085,0.025,104,347,0.008,43447,POINT (-87.714238 41.745398),60652-20210125
60623,12/26/2020,4,159,4,159,0.002,0,0,0,81283,POINT (-87.717446 41.850321),60623-20201226
60620,01/12/2021,62,734,39,623,0.009,23,111,0.002,67711,POINT (-87.651656 41.740873),60620-20210112
60617,12/18/2020,32,57,32,57,0.001,0,0,0,83553,POINT (-87.556897 41.721257),60617-20201218
60623,02/01/2021,204,3101,182,2607,0.032,22,494,0.006,81283,POINT (-87.717446 41.850321),60623-20210201
60643,12/25/2020,0,312,0,312,0.006,0,0,0,48887,POINT (-87.662381 41.700445),60643-20201225
60606,01/19/2021,9,296,5,197,0.06,4,99,0.03,3287,POINT (-87.63676 41.882634),60606-20210119
60707,01/08/2021,19,188,12,172,0.004,7,16,0,43093,POINT (-87.808283 41.921777),60707-20210108
60623,01/22/2021,184,1702,179,1461,0.018,5,241,0.003,81283,POINT (-87.717446 41.850321),60623-20210122
60631,01/14/2021,56,1433,47,1111,0.038,9,322,0.011,29529,POINT (-87.813371 41.995019),60631-20210114
60606,01/24/2021,4,379,4,257,0.078,0,122,0.037,3287,POINT (-87.63676 41.882634),60606-20210124
60666,12/27/2020,0,0,0,0,0,0,0,0,0,POINT (-87.896371 41.979511),60666-20201227
60640,01/02/2021,34,1229,34,1229,0.018,0,0,0,69363,POINT (-87.662232 41.971888),60640-20210102
60626,12/24/2020,14,337,14,337,0.007,0,0,0,50544,POINT (-87.669834 42.009469),60626-20201224
60646,12/19/2020,53,156,53,156,0.005,0,0,0,28569,POINT (-87.761826 41.993931),60646-20201219
60616,02/02/2021,322,5263,213,3991,0.074,109,1272,0.023,54197,POINT (-87.629531 41.844869),60616-20210202
60631,12/28/2020,16,363,16,363,0.012,0,0,0,29529,POINT (-87.813371 41.995019),60631-20201228
60628,12/20/2020,6,44,6,44,0.001,0,0,0,64254,POINT (-87.621537 41.694192),60628-20201220
60601,01/29/2021,116,1800,105,1310,0.087,11,490,0.032,15083,POINT (-87.622844 41.886262),60601-20210129
60642,12/15/2020,0,0,0,0,0,0,0,0,19716,POINT (-87.657821 41.899935),60642-20201215
60610,01/27/2021,184,4108,137,3049,0.075,47,1059,0.026,40548,POINT (-87.63581 41.90455),60610-20210127
60636,12/26/2020,2,33,2,33,0.001,0,0,0,30024,POINT (-87.668597 41.77599),60636-20201226
60660,01/28/2021,214,3842,169,3110,0.07,45,732,0.016,44498,POINT (-87.666362 41.991062),60660-20210128
60629,01/27/2021,230,2953,198,2420,0.022,32,533,0.005,110029,POINT (-87.711565 41.777061),60629-20210127
60827,02/23/2021,4,195,2,136,0.005,2,59,0.002,28483,POINT (-87.633087 41.650765),60827-20210223
60651,01/03/2021,2,252,2,252,0.004,0,0,0,63492,POINT (-87.741017 41.901964),60651-20210103
Unknown,02/08/2021,9,1270,8,975,0,1,295,0,0,,Unknown-20210208
60620,12/16/2020,0,0,0,0,0,0,0,0,67711,POINT (-87.651656 41.740873),60620-20201216
60601,01/16/2021,25,1002,20,699,0.046,5,303,0.02,15083,POINT (-87.622844 41.886262),60601-20210116
60601,01/18/2021,31,1046,10,716,0.047,21,330,0.022,15083,POINT (-87.622844 41.886262),60601-20210118
60617,01/09/2021,32,687,19,610,0.007,13,77,0.001,83553,POINT (-87.556897 41.721257),60617-20210109
60642,01/21/2021,97,1960,74,1309,0.066,23,651,0.033,19716,POINT (-87.657821 41.899935),60642-20210121
60666,01/28/2021,1,6,1,6,0,0,0,0,0,POINT (-87.896371 41.979511),60666-20210128
60666,02/23/2021,1,27,0,23,0,1,4,0,0,POINT (-87.896371 41.979511),60666-20210223
60623,01/15/2021,48,1119,47,981,0.012,1,138,0.002,81283,POINT (-87.717446 41.850321),60623-20210115
60656,12/22/2020,16,178,16,178,0.006,0,0,0,28218,POINT (-87.817934 41.974566),60656-20201222
60827,01/22/2021,3,48,3,42,0.001,0,6,0,28483,POINT (-87.633087 41.650765),60827-20210122
60666,01/09/2021,0,0,0,0,0,0,0,0,0,POINT (-87.896371 41.979511),60666-20210109
60645,12/28/2020,32,321,32,321,0.007,0,0,0,47270,POINT (-87.695049 42.008927),60645-20201228
60649,12/28/2020,21,143,21,143,0.003,0,0,0,46633,POINT (-87.571522 41.762202),60649-20201228
60610,01/15/2021,91,2263,78,1614,0.04,13,649,0.016,40548,POINT (-87.63581 41.90455),60610-20210115
60656,01/23/2021,44,1076,39,825,0.029,5,251,0.009,28218,POINT (-87.817934 41.974566),60656-20210123
60628,12/15/2020,0,0,0,0,0,0,0,0,64254,POINT (-87.621537 41.694192),60628-20201215
60636,01/12/2021,15,196,11,177,0.006,4,19,0.001,30024,POINT (-87.668597 41.77599),60636-20210112
60646,01/05/2021,62,595,62,595,0.021,0,0,0,28569,POINT (-87.761826 41.993931),60646-20210105
60827,02/28/2021,5,243,4,172,0.006,1,71,0.002,28483,POINT (-87.633087 41.650765),60827-20210228
60638,12/19/2020,48,143,48,143,0.002,0,0,0,58669,POINT (-87.771902 41.787032),60638-20201219
60608,01/11/2021,121,1848,34,1518,0.019,87,330,0.004,80059,POINT (-87.670366 41.849879),60608-20210111
60827,02/06/2021,3,117,2,97,0.003,1,20,0.001,28483,POINT (-87.633087 41.650765),60827-20210206
60601,01/01/2021,1,416,1,416,0.028,0,0,0,15083,POINT (-87.622844 41.886262),60601-20210101
60652,01/04/2021,30,435,29,434,0.01,1,1,0,43447,POINT (-87.714238 41.745398),60652-20210104
60652,01/14/2021,43,828,39,695,0.016,4,133,0.003,43447,POINT (-87.714238 41.745398),60652-20210114
60606,02/07/2021,6,613,6,445,0.135,0,168,0.051,3287,POINT (-87.63676 41.882634),60606-20210207
60640,12/23/2020,80,686,80,686,0.01,0,0,0,69363,POINT (-87.662232 41.971888),60640-20201223
60646,01/26/2021,118,2287,86,1812,0.063,32,475,0.017,28569,POINT (-87.761826 41.993931),60646-20210126
60632,01/20/2021,154,1371,115,1124,0.013,39,247,0.003,89857,POINT (-87.711251 41.810038),60632-20210120
60707,12/22/2020,14,56,14,56,0.001,0,0,0,43093,POINT (-87.808283 41.921777),60707-20201222
60624,01/23/2021,16,641,16,544,0.016,0,97,0.003,34892,POINT (-87.722735 41.879417),60624-20210123
60649,01/10/2021,5,618,3,566,0.012,2,52,0.001,46633,POINT (-87.571522 41.762202),60649-20210110
60649,01/21/2021,148,1515,129,1339,0.029,19,176,0.004,46633,POINT (-87.571522 41.762202),60649-20210121
60613,01/23/2021,132,4455,124,3349,0.066,8,1106,0.022,50761,POINT (-87.661343 41.953742),60613-20210123
60656,01/06/2021,24,390,18,384,0.014,6,6,0,28218,POINT (-87.817934 41.974566),60656-20210106
60625,01/28/2021,280,5501,229,4267,0.054,51,1234,0.016,79444,POINT (-87.701816 41.971155),60625-20210128
60646,01/02/2021,15,476,15,476,0.017,0,0,0,28569,POINT (-87.761826 41.993931),60646-20210102
60645,01/27/2021,292,3516,164,2806,0.059,128,710,0.015,47270,POINT (-87.695049 42.008927),60645-20210127
60608,12/31/2020,67,912,67,912,0.011,0,0,0,80059,POINT (-87.670366 41.849879),60608-20201231
Unknown,02/13/2021,42,1579,20,1083,0,22,496,0,0,,Unknown-20210213
60646,01/17/2021,22,1314,15,1002,0.035,7,312,0.011,28569,POINT (-87.761826 41.993931),60646-20210117
60642,01/12/2021,119,1423,51,996,0.051,68,427,0.022,19716,POINT (-87.657821 41.899935),60642-20210112
60606,01/17/2021,2,280,2,190,0.058,0,90,0.027,3287,POINT (-87.63676 41.882634),60606-20210117
60641,12/21/2020,87,302,87,302,0.004,0,0,0,69880,POINT (-87.746791 41.946682),60641-20201221
60653,01/08/2021,58,589,30,533,0.016,28,56,0.002,33154,POINT (-87.611244 41.819261),60653-20210108
60606,12/27/2020,1,92,1,92,0.028,0,0,0,3287,POINT (-87.63676 41.882634),60606-20201227
60644,01/20/2021,57,1074,39,957,0.021,18,117,0.003,46591,POINT (-87.756863 41.881113),60644-20210120
60628,01/04/2021,132,373,132,372,0.006,0,1,0,64254,POINT (-87.621537 41.694192),60628-20210104
60630,01/25/2021,138,2837,104,2211,0.039,34,626,0.011,56433,POINT (-87.759611 41.971261),60630-20210125
60625,12/27/2020,0,643,0,643,0.008,0,0,0,79444,POINT (-87.701816 41.971155),60625-20201227
60601,01/06/2021,20,519,13,508,0.034,7,11,0.001,15083,POINT (-87.622844 41.886262),60601-20210106
60633,02/24/2021,42,1191,23,873,0.069,19,318,0.025,12689,POINT (-87.556037 41.653147),60633-20210224
60641,01/01/2021,0,673,0,673,0.01,0,0,0,69880,POINT (-87.746791 41.946682),60641-20210101
60649,12/24/2020,14,121,14,121,0.003,0,0,0,46633,POINT (-87.571522 41.762202),60649-20201224
60657,01/05/2021,221,2574,208,2551,0.036,13,23,0,70958,POINT (-87.658216 41.939715),60657-20210105
60601,01/28/2021,88,1684,68,1205,0.08,20,479,0.032,15083,POINT (-87.622844 41.886262),60601-20210128
60610,01/14/2021,89,2172,68,1536,0.038,21,636,0.016,40548,POINT (-87.63581 41.90455),60610-20210114
60644,01/26/2021,61,1465,49,1269,0.027,12,196,0.004,46591,POINT (-87.756863 41.881113),60644-20210126
60651,01/05/2021,62,343,62,341,0.005,0,2,0,63492,POINT (-87.741017 41.901964),60651-20210105
60637,12/20/2020,21,143,21,143,0.003,0,0,0,47300,POINT (-87.604053 41.780991),60637-20201220
60630,12/19/2020,81,210,81,210,0.004,0,0,0,56433,POINT (-87.759611 41.971261),60630-20201219
60661,01/03/2021,7,478,7,478,0.046,0,0,0,10354,POINT (-87.644283 41.882786),60661-20210103
60642,01/28/2021,107,2475,84,1674,0.085,23,801,0.041,19716,POINT (-87.657821 41.899935),60642-20210128
60623,01/20/2021,118,1385,86,1165,0.014,32,220,0.003,81283,POINT (-87.717446 41.850321),60623-20210120
60622,12/29/2020,259,1700,259,1700,0.032,0,0,0,53294,POINT (-87.681818 41.902762),60622-20201229
60642,01/23/2021,45,2085,41,1420,0.072,4,665,0.034,19716,POINT (-87.657821 41.899935),60642-20210123
60653,12/29/2020,150,342,150,342,0.01,0,0,0,33154,POINT (-87.611244 41.819261),60653-20201229
60645,12/22/2020,38,237,38,237,0.005,0,0,0,47270,POINT (-87.695049 42.008927),60645-20201222
60610,01/25/2021,156,3704,116,2788,0.069,40,916,0.023,40548,POINT (-87.63581 41.90455),60610-20210125
60827,02/19/2021,7,174,2,126,0.004,5,48,0.002,28483,POINT (-87.633087 41.650765),60827-20210219
60626,12/30/2020,294,716,294,716,0.014,0,0,0,50544,POINT (-87.669834 42.009469),60626-20201230
60637,01/06/2021,109,938,93,895,0.019,16,43,0.001,47300,POINT (-87.604053 41.780991),60637-20210106
60641,01/11/2021,101,1425,41,1147,0.016,60,278,0.004,69880,POINT (-87.746791 41.946682),60641-20210111
60647,01/10/2021,47,2440,23,1911,0.022,24,529,0.006,87633,POINT (-87.701101 41.921058),60647-20210110
60612,01/01/2021,0,798,0,798,0.024,0,0,0,33735,POINT (-87.687011 41.88004),60612-20210101
60610,12/24/2020,21,644,21,644,0.016,0,0,0,40548,POINT (-87.63581 41.90455),60610-20201224
60707,01/03/2021,4,126,4,126,0.003,0,0,0,43093,POINT (-87.808283 41.921777),60707-20210103
60655,12/15/2020,0,0,0,0,0,0,0,0,28569,POINT (-87.701434 41.696456),60655-20201215
Unknown,12/18/2020,4,8,4,8,0,0,0,0,0,,Unknown-20201218
60613,01/06/2021,82,1571,61,1534,0.03,21,37,0.001,50761,POINT (-87.661343 41.953742),60613-20210106
60602,01/24/2021,1,208,1,164,0.143,0,44,0.038,1145,POINT (-87.628309 41.883136),60602-20210124
60624,12/16/2020,1,1,1,1,0,0,0,0,34892,POINT (-87.722735 41.879417),60624-20201216
60651,12/17/2020,5,5,5,5,0,0,0,0,63492,POINT (-87.741017 41.901964),60651-20201217
60661,01/22/2021,35,1262,33,832,0.08,2,430,0.042,10354,POINT (-87.644283 41.882786),60661-20210122
60651,12/31/2020,18,237,18,237,0.004,0,0,0,63492,POINT (-87.741017 41.901964),60651-20201231
60666,12/28/2020,0,0,0,0,0,0,0,0,0,POINT (-87.896371 41.979511),60666-20201228
Unknown,12/25/2020,0,38,0,38,0,0,0,0,0,,Unknown-20201225
60639,12/24/2020,13,216,13,216,0.002,0,0,0,88204,POINT (-87.75531 41.920609),60639-20201224
60622,01/15/2021,124,4643,115,3353,0.063,9,1290,0.024,53294,POINT (-87.681818 41.902762),60622-20210115
60629,01/12/2021,104,1126,56,916,0.008,48,210,0.002,110029,POINT (-87.711565 41.777061),60629-20210112
60617,12/23/2020,32,189,32,189,0.002,0,0,0,83553,POINT (-87.556897 41.721257),60617-20201223
60660,01/23/2021,89,3053,77,2547,0.057,12,506,0.011,44498,POINT (-87.666362 41.991062),60660-20210123
60637,01/27/2021,130,3399,100,2610,0.055,30,789,0.017,47300,POINT (-87.604053 41.780991),60637-20210127
60620,12/21/2020,13,82,13,82,0.001,0,0,0,67711,POINT (-87.651656 41.740873),60620-20201221
60639,01/03/2021,12,417,11,416,0.005,1,1,0,88204,POINT (-87.75531 41.920609),60639-20210103
60601,01/11/2021,67,784,12,574,0.038,55,210,0.014,15083,POINT (-87.622844 41.886262),60601-20210111
60651,12/26/2020,3,115,3,115,0.002,0,0,0,63492,POINT (-87.741017 41.901964),60651-20201226
60606,01/07/2021,9,159,5,146,0.044,4,13,0.004,3287,POINT (-87.63676 41.882634),60606-20210107
60644,12/30/2020,32,205,32,205,0.004,0,0,0,46591,POINT (-87.756863 41.881113),60644-20201230
60609,01/01/2021,0,336,0,336,0.006,0,0,0,60939,POINT (-87.653382 41.812017),60609-20210101
60619,01/08/2021,59,482,35,442,0.007,24,40,0.001,61207,POINT (-87.60569 41.744737),60619-20210108
60644,01/09/2021,14,675,10,648,0.014,4,27,0.001,46591,POINT (-87.756863 41.881113),60644-20210109
60827,12/17/2020,0,0,0,0,0,0,0,0,28483,POINT (-87.633087 41.650765),60827-20201217
60827,12/28/2020,0,7,0,7,0,0,0,0,28483,POINT (-87.633087 41.650765),60827-20201228
60606,12/16/2020,0,0,0,0,0,0,0,0,3287,POINT (-87.63676 41.882634),60606-20201216
60620,01/05/2021,37,342,33,333,0.005,4,9,0,67711,POINT (-87.651656 41.740873),60620-20210105
60707,01/23/2021,28,597,28,492,0.011,0,105,0.002,43093,POINT (-87.808283 41.921777),60707-20210123
60601,12/27/2020,0,318,0,318,0.021,0,0,0,15083,POINT (-87.622844 41.886262),60601-20201227
60630,12/24/2020,12,426,12,426,0.008,0,0,0,56433,POINT (-87.759611 41.971261),60630-20201224
60827,01/18/2021,1,36,1,31,0.001,0,5,0,28483,POINT (-87.633087 41.650765),60827-20210118
60606,02/08/2021,9,622,8,453,0.138,1,169,0.051,3287,POINT (-87.63676 41.882634),60606-20210208
60613,12/15/2020,0,0,0,0,0,0,0,0,50761,POINT (-87.661343 41.953742),60613-20201215
60653,12/22/2020,32,133,32,133,0.004,0,0,0,33154,POINT (-87.611244 41.819261),60653-20201222
60631,01/30/2021,284,3204,166,2533,0.086,118,671,0.023,29529,POINT (-87.813371 41.995019),60631-20210130
60630,01/20/2021,135,2234,88,1703,0.03,47,531,0.009,56433,POINT (-87.759611 41.971261),60630-20210120
60608,01/10/2021,99,1727,88,1484,0.019,11,243,0.003,80059,POINT (-87.670366 41.849879),60608-20210110
60628,12/16/2020,0,0,0,0,0,0,0,0,64254,POINT (-87.621537 41.694192),60628-20201216
Unknown,02/23/2021,56,1915,16,1211,0,40,704,0,0,,Unknown-20210223
60605,12/16/2020,11,11,11,11,0,0,0,0,29060,POINT (-87.623449 41.867824),60605-20201216
60631,01/15/2021,45,1478,40,1151,0.039,5,327,0.011,29529,POINT (-87.813371 41.995019),60631-20210115
60642,12/24/2020,15,513,15,513,0.026,0,0,0,19716,POINT (-87.657821 41.899935),60642-20201224
60640,12/20/2020,17,331,17,331,0.005,0,0,0,69363,POINT (-87.662232 41.971888),60640-20201220
60617,01/07/2021,57,583,33,548,0.007,24,35,0,83553,POINT (-87.556897 41.721257),60617-20210107
60642,01/19/2021,63,1764,29,1188,0.06,34,576,0.029,19716,POINT (-87.657821 41.899935),60642-20210119
Unknown,01/27/2021,59,810,44,691,0,15,119,0,0,,Unknown-20210127
60611,12/22/2020,182,1522,182,1522,0.046,0,0,0,33224,POINT (-87.620291 41.894734),60611-20201222
60652,01/13/2021,78,785,54,656,0.015,24,129,0.003,43447,POINT (-87.714238 41.745398),60652-20210113
60638,12/23/2020,34,311,34,311,0.005,0,0,0,58669,POINT (-87.771902 41.787032),60638-20201223
60644,12/25/2020,0,82,0,82,0.002,0,0,0,46591,POINT (-87.756863 41.881113),60644-20201225
60610,12/26/2020,15,659,15,659,0.016,0,0,0,40548,POINT (-87.63581 41.90455),60610-20201226
60660,01/08/2021,194,1727,105,1572,0.035,89,155,0.003,44498,POINT (-87.666362 41.991062),60660-20210108
60660,12/21/2020,59,243,59,243,0.005,0,0,0,44498,POINT (-87.666362 41.991062),60660-20201221
60607,01/14/2021,112,3148,79,2194,0.075,33,954,0.033,29293,POINT (-87.652727 41.876104),60607-20210114
60611,01/08/2021,962,3606,440,2843,0.086,522,763,0.023,33224,POINT (-87.620291 41.894734),60611-20210108
60623,01/01/2021,0,394,0,394,0.005,0,0,0,81283,POINT (-87.717446 41.850321),60623-20210101
60666,01/29/2021,3,9,3,9,0,0,0,0,0,POINT (-87.896371 41.979511),60666-20210129
60625,01/09/2021,107,2091,44,1794,0.023,63,297,0.004,79444,POINT (-87.701816 41.971155),60625-20210109
60651,12/21/2020,19,69,19,69,0.001,0,0,0,63492,POINT (-87.741017 41.901964),60651-20201221
60827,02/02/2021,7,92,5,77,0.003,2,15,0.001,28483,POINT (-87.633087 41.650765),60827-20210202
60638,01/13/2021,89,1209,60,917,0.016,29,292,0.005,58669,POINT (-87.771902 41.787032),60638-20210113
60641,01/22/2021,198,2746,182,2142,0.031,16,604,0.009,69880,POINT (-87.746791 41.946682),60641-20210122
60618,12/21/2020,179,629,179,629,0.007,0,0,0,94907,POINT (-87.703343 41.946699),60618-20201221
60643,12/18/2020,58,86,58,86,0.002,0,0,0,48887,POINT (-87.662381 41.700445),60643-20201218
60633,01/08/2021,7,97,6,86,0.007,1,11,0.001,12689,POINT (-87.556037 41.653147),60633-20210108
60638,01/07/2021,85,790,38,730,0.012,47,60,0.001,58669,POINT (-87.771902 41.787032),60638-20210107
60647,12/19/2020,160,497,160,497,0.006,0,0,0,87633,POINT (-87.701101 41.921058),60647-20201219
60628,01/11/2021,23,585,11,523,0.008,12,62,0.001,64254,POINT (-87.621537 41.694192),60628-20210111
60652,01/18/2021,28,917,20,762,0.018,8,155,0.004,43447,POINT (-87.714238 41.745398),60652-20210118
60605,01/07/2021,221,2123,56,1862,0.064,165,261,0.009,29060,POINT (-87.623449 41.867824),60605-20210107
60657,12/19/2020,227,721,227,721,0.01,0,0,0,70958,POINT (-87.658216 41.939715),60657-20201219
60651,01/15/2021,44,708,40,608,0.01,4,100,0.002,63492,POINT (-87.741017 41.901964),60651-20210115
60633,01/23/2021,16,247,14,200,0.016,2,47,0.004,12689,POINT (-87.556037 41.653147),60633-20210123
Unknown,01/22/2021,42,666,40,580,0,2,86,0,0,,Unknown-20210122
60633,12/22/2020,5,19,5,19,0.001,0,0,0,12689,POINT (-87.556037 41.653147),60633-20201222
60622,01/21/2021,336,5643,258,4001,0.075,78,1642,0.031,53294,POINT (-87.681818 41.902762),60622-20210121
60633,02/09/2021,37,687,32,577,0.045,5,110,0.009,12689,POINT (-87.556037 41.653147),60633-20210209
60617,12/25/2020,0,199,0,199,0.002,0,0,0,83553,POINT (-87.556897 41.721257),60617-20201225
60610,12/17/2020,63,65,63,65,0.002,0,0,0,40548,POINT (-87.63581 41.90455),60610-20201217
60645,01/12/2021,149,1555,122,1338,0.028,27,217,0.005,47270,POINT (-87.695049 42.008927),60645-20210112
60649,01/06/2021,22,400,21,395,0.008,1,5,0,46633,POINT (-87.571522 41.762202),60649-20210106
60660,01/17/2021,27,2343,20,2000,0.045,7,343,0.008,44498,POINT (-87.666362 41.991062),60660-20210117
60613,01/27/2021,230,5313,168,3960,0.078,62,1353,0.027,50761,POINT (-87.661343 41.953742),60613-20210127
60613,12/26/2020,19,823,19,823,0.016,0,0,0,50761,POINT (-87.661343 41.953742),60613-20201226
60645,01/10/2021,15,1333,8,1187,0.025,7,146,0.003,47270,POINT (-87.695049 42.008927),60645-20210110
60629,01/26/2021,195,2723,143,2222,0.02,52,501,0.005,110029,POINT (-87.711565 41.777061),60629-20210126
60622,12/15/2020,0,0,0,0,0,0,0,0,53294,POINT (-87.681818 41.902762),60622-20201215
60646,12/16/2020,0,0,0,0,0,0,0,0,28569,POINT (-87.761826 41.993931),60646-20201216
60632,01/02/2021,12,416,12,416,0.005,0,0,0,89857,POINT (-87.711251 41.810038),60632-20210102
60666,02/18/2021,1,25,1,23,0,0,2,0,0,POINT (-87.896371 41.979511),60666-20210218
60605,01/22/2021,214,4258,193,2752,0.095,21,1506,0.052,29060,POINT (-87.623449 41.867824),60605-20210122
60602,12/23/2020,4,28,4,28,0.024,0,0,0,1145,POINT (-87.628309 41.883136),60602-20201223
60616,01/08/2021,173,1622,39,1350,0.025,134,272,0.005,54197,POINT (-87.629531 41.844869),60616-20210108
60632,12/21/2020,31,84,31,84,0.001,0,0,0,89857,POINT (-87.711251 41.810038),60632-20201221
60652,12/27/2020,0,157,0,157,0.004,0,0,0,43447,POINT (-87.714238 41.745398),60652-20201227
60632,01/05/2021,44,515,43,513,0.006,1,2,0,89857,POINT (-87.711251 41.810038),60632-20210105
60616,01/23/2021,116,3385,105,2496,0.046,11,889,0.016,54197,POINT (-87.629531 41.844869),60616-20210123
60625,01/06/2021,177,1612,164,1592,0.02,13,20,0,79444,POINT (-87.701816 41.971155),60625-20210106
60629,12/28/2020,33,320,33,320,0.003,0,0,0,110029,POINT (-87.711565 41.777061),60629-20201228
60629,01/29/2021,332,3529,302,2925,0.027,30,604,0.005,110029,POINT (-87.711565 41.777061),60629-20210129
60661,01/31/2021,5,1541,3,1007,0.097,2,534,0.052,10354,POINT (-87.644283 41.882786),60661-20210131
60633,02/13/2021,20,870,10,698,0.055,10,172,0.014,12689,POINT (-87.556037 41.653147),60633-20210213
60606,12/31/2020,5,123,5,123,0.037,0,0,0,3287,POINT (-87.63676 41.882634),60606-20201231
60632,01/27/2021,291,2319,231,1916,0.021,60,403,0.004,89857,POINT (-87.711251 41.810038),60632-20210127
60656,01/02/2021,21,306,21,306,0.011,0,0,0,28218,POINT (-87.817934 41.974566),60656-20210102
60602,01/19/2021,19,151,11,110,0.096,8,41,0.036,1145,POINT (-87.628309 41.883136),60602-20210119
60660,12/31/2020,32,589,32,589,0.013,0,0,0,44498,POINT (-87.666362 41.991062),60660-20201231
60630,01/29/2021,200,3628,177,2844,0.05,23,784,0.014,56433,POINT (-87.759611 41.971261),60630-20210129
60637,01/11/2021,52,1269,7,1011,0.021,45,258,0.005,47300,POINT (-87.604053 41.780991),60637-20210111
60651,01/27/2021,131,1553,118,1302,0.021,13,251,0.004,63492,POINT (-87.741017 41.901964),60651-20210127
60641,01/07/2021,100,1092,41,1004,0.014,59,88,0.001,69880,POINT (-87.746791 41.946682),60641-20210107
60619,12/19/2020,11,45,11,45,0.001,0,0,0,61207,POINT (-87.60569 41.744737),60619-20201219
60617,01/18/2021,65,1193,52,980,0.012,13,213,0.003,83553,POINT (-87.556897 41.721257),60617-20210118
60666,12/16/2020,0,0,0,0,0,0,0,0,0,POINT (-87.896371 41.979511),60666-20201216
60644,01/24/2021,3,1276,3,1147,0.025,0,129,0.003,46591,POINT (-87.756863 41.881113),60644-20210124
60630,01/14/2021,95,1782,78,1378,0.024,17,404,0.007,56433,POINT (-87.759611 41.971261),60630-20210114
60653,01/04/2021,19,430,18,429,0.013,1,1,0,33154,POINT (-87.611244 41.819261),60653-20210104
60611,12/19/2020,193,895,193,895,0.027,0,0,0,33224,POINT (-87.620291 41.894734),60611-20201219
60649,12/20/2020,2,50,2,50,0.001,0,0,0,46633,POINT (-87.571522 41.762202),60649-20201220
60610,01/18/2021,105,2457,53,1738,0.043,52,719,0.018,40548,POINT (-87.63581 41.90455),60610-20210118
60633,12/19/2020,5,9,5,9,0.001,0,0,0,12689,POINT (-87.556037 41.653147),60633-20201219
60661,12/30/2020,32,438,32,438,0.042,0,0,0,10354,POINT (-87.644283 41.882786),60661-20201230
Unknown,01/02/2021,1,88,1,88,0,0,0,0,0,,Unknown-20210102
60621,12/29/2020,12,106,12,106,0.004,0,0,0,28018,POINT (-87.638812 41.776931),60621-20201229
60624,12/27/2020,0,59,0,59,0.002,0,0,0,34892,POINT (-87.722735 41.879417),60624-20201227
60606,01/13/2021,8,255,3,168,0.051,5,87,0.026,3287,POINT (-87.63676 41.882634),60606-20210113
60645,12/26/2020,5,289,5,289,0.006,0,0,0,47270,POINT (-87.695049 42.008927),60645-20201226
60652,01/01/2021,0,382,0,382,0.009,0,0,0,43447,POINT (-87.714238 41.745398),60652-20210101
60602,12/18/2020,7,8,7,8,0.007,0,0,0,1145,POINT (-87.628309 41.883136),60602-20201218
60640,01/04/2021,198,1525,191,1518,0.022,7,7,0,69363,POINT (-87.662232 41.971888),60640-20210104
60618,01/07/2021,185,2107,78,1964,0.021,107,143,0.002,94907,POINT (-87.703343 41.946699),60618-20210107
60631,01/06/2021,55,805,37,785,0.027,18,20,0.001,29529,POINT (-87.813371 41.995019),60631-20210106
60620,12/25/2020,0,133,0,133,0.002,0,0,0,67711,POINT (-87.651656 41.740873),60620-20201225
60631,01/21/2021,113,1981,102,1584,0.054,11,397,0.013,29529,POINT (-87.813371 41.995019),60631-20210121
60657,01/01/2021,4,2072,4,2072,0.029,0,0,0,70958,POINT (-87.658216 41.939715),60657-20210101
60610,01/19/2021,116,2573,68,1806,0.045,48,767,0.019,40548,POINT (-87.63581 41.90455),60610-20210119
Unknown,02/18/2021,72,1747,15,1145,0,57,602,0,0,,Unknown-20210218
60606,02/14/2021,5,753,0,522,0.159,5,231,0.07,3287,POINT (-87.63676 41.882634),60606-20210214
60608,01/05/2021,69,1102,65,1092,0.014,4,10,0,80059,POINT (-87.670366 41.849879),60608-20210105
60601,12/22/2020,48,269,48,269,0.018,0,0,0,15083,POINT (-87.622844 41.886262),60601-20201222
60623,12/21/2020,31,87,31,87,0.001,0,0,0,81283,POINT (-87.717446 41.850321),60623-20201221
60637,01/01/2021,1,619,1,619,0.013,0,0,0,47300,POINT (-87.604053 41.780991),60637-20210101
60827,02/15/2021,2,150,0,119,0.004,2,31,0.001,28483,POINT (-87.633087 41.650765),60827-20210215
60629,12/25/2020,0,277,0,277,0.003,0,0,0,110029,POINT (-87.711565 41.777061),60629-20201225
60605,12/21/2020,175,815,175,815,0.028,0,0,0,29060,POINT (-87.623449 41.867824),60605-20201221
60660,12/16/2020,2,2,2,2,0,0,0,0,44498,POINT (-87.666362 41.991062),60660-20201216
60607,01/25/2021,193,4451,75,2995,0.102,118,1456,0.05,29293,POINT (-87.652727 41.876104),60607-20210125
Unknown,12/29/2020,17,60,17,60,0,0,0,0,0,,Unknown-20201229
60612,01/06/2021,52,998,43,986,0.029,9,12,0,33735,POINT (-87.687011 41.88004),60612-20210106
60601,01/23/2021,30,1396,29,1003,0.066,1,393,0.026,15083,POINT (-87.622844 41.886262),60601-20210123
60609,01/09/2021,34,682,23,621,0.01,11,61,0.001,60939,POINT (-87.653382 41.812017),60609-20210109
60624,12/22/2020,14,49,14,49,0.001,0,0,0,34892,POINT (-87.722735 41.879417),60624-20201222
60606,01/28/2021,21,458,19,323,0.098,2,135,0.041,3287,POINT (-87.63676 41.882634),60606-20210128
60643,01/02/2021,12,470,12,470,0.01,0,0,0,48887,POINT (-87.662381 41.700445),60643-20210102
60602,01/04/2021,3,50,3,50,0.044,0,0,0,1145,POINT (-87.628309 41.883136),60602-20210104
60604,12/26/2020,0,7,0,7,0.009,0,0,0,823,POINT (-87.629029 41.878153),60604-20201226
60622,01/13/2021,217,4309,99,3066,0.058,118,1243,0.023,53294,POINT (-87.681818 41.902762),60622-20210113
60661,12/25/2020,0,351,0,351,0.034,0,0,0,10354,POINT (-87.644283 41.882786),60661-20201225
60611,01/15/2021,87,4914,73,3283,0.099,14,1631,0.049,33224,POINT (-87.620291 41.894734),60611-20210115
60666,12/21/2020,0,0,0,0,0,0,0,0,0,POINT (-87.896371 41.979511),60666-20201221
60626,01/03/2021,19,780,18,779,0.015,1,1,0,50544,POINT (-87.669834 42.009469),60626-20210103
60647,01/08/2021,294,2219,84,1838,0.021,210,381,0.004,87633,POINT (-87.701101 41.921058),60647-20210108
60642,01/08/2021,147,1094,29,888,0.045,118,206,0.01,19716,POINT (-87.657821 41.899935),60642-20210108
60640,12/25/2020,0,725,0,725,0.01,0,0,0,69363,POINT (-87.662232 41.971888),60640-20201225
60632,01/22/2021,128,1632,119,1358,0.015,9,274,0.003,89857,POINT (-87.711251 41.810038),60632-20210122
60707,02/16/2021,27,1809,22,1436,0.033,5,373,0.009,43093,POINT (-87.808283 41.921777),60707-20210216
60646,01/14/2021,45,1204,35,906,0.032,10,298,0.01,28569,POINT (-87.761826 41.993931),60646-20210114
60621,12/26/2020,1,34,1,34,0.001,0,0,0,28018,POINT (-87.638812 41.776931),60621-20201226
60619,01/19/2021,108,1066,85,917,0.015,23,149,0.002,61207,POINT (-87.60569 41.744737),60619-20210119
60630,12/28/2020,34,469,34,469,0.008,0,0,0,56433,POINT (-87.759611 41.971261),60630-20201228
60707,01/15/2021,16,315,14,250,0.006,2,65,0.002,43093,POINT (-87.808283 41.921777),60707-20210115
60612,12/20/2020,12,221,12,221,0.007,0,0,0,33735,POINT (-87.687011 41.88004),60612-20201220
60628,01/21/2021,101,1151,90,967,0.015,11,184,0.003,64254,POINT (-87.621537 41.694192),60628-20210121
60666,01/04/2021,0,0,0,0,0,0,0,0,0,POINT (-87.896371 41.979511),60666-20210104
60616,12/20/2020,37,341,37,341,0.006,0,0,0,54197,POINT (-87.629531 41.844869),60616-20201220
60644,01/05/2021,231,569,231,569,0.012,0,0,0,46591,POINT (-87.756863 41.881113),60644-20210105
60607,12/24/2020,43,997,43,997,0.034,0,0,0,29293,POINT (-87.652727 41.876104),60607-20201224
60639,12/31/2020,40,378,40,378,0.004,0,0,0,88204,POINT (-87.75531 41.920609),60639-20201231
Unknown,01/17/2021,1,380,1,339,0,0,41,0,0,,Unknown-20210117
60666,01/17/2021,0,1,0,1,0,0,0,0,0,POINT (-87.896371 41.979511),60666-20210117
60666,02/15/2021,0,23,0,21,0,0,2,0,0,POINT (-87.896371 41.979511),60666-20210215
60625,12/20/2020,7,303,7,303,0.004,0,0,0,79444,POINT (-87.701816 41.971155),60625-20201220
60629,01/07/2021,75,780,46,742,0.007,29,38,0,110029,POINT (-87.711565 41.777061),60629-20210107
60653,12/18/2020,27,37,27,37,0.001,0,0,0,33154,POINT (-87.611244 41.819261),60653-20201218
60607,01/10/2021,30,2466,8,1927,0.066,22,539,0.018,29293,POINT (-87.652727 41.876104),60607-20210110
60656,01/15/2021,24,747,20,547,0.019,4,200,0.007,28218,POINT (-87.817934 41.974566),60656-20210115
60639,12/19/2020,34,85,34,85,0.001,0,0,0,88204,POINT (-87.75531 41.920609),60639-20201219
60611,01/20/2021,168,5574,115,3593,0.108,53,1981,0.06,33224,POINT (-87.620291 41.894734),60611-20210120
60636,01/15/2021,11,239,10,212,0.007,1,27,0.001,30024,POINT (-87.668597 41.77599),60636-20210115
60827,01/01/2021,0,9,0,9,0,0,0,0,28483,POINT (-87.633087 41.650765),60827-20210101
60609,12/22/2020,34,137,34,137,0.002,0,0,0,60939,POINT (-87.653382 41.812017),60609-20201222
60638,12/27/2020,0,327,0,327,0.006,0,0,0,58669,POINT (-87.771902 41.787032),60638-20201227
60636,01/20/2021,28,312,20,266,0.009,8,46,0.002,30024,POINT (-87.668597 41.77599),60636-20210120
60618,12/28/2020,71,1014,71,1014,0.011,0,0,0,94907,POINT (-87.703343 41.946699),60618-20201228
60666,02/05/2021,0,14,0,14,0,0,0,0,0,POINT (-87.896371 41.979511),60666-20210205
60657,12/23/2020,147,1400,147,1400,0.02,0,0,0,70958,POINT (-87.658216 41.939715),60657-20201223
60605,01/17/2021,29,3532,15,2300,0.079,14,1232,0.042,29060,POINT (-87.623449 41.867824),60605-20210117
60643,12/28/2020,17,331,17,331,0.007,0,0,0,48887,POINT (-87.662381 41.700445),60643-20201228
60612,12/15/2020,0,0,0,0,0,0,0,0,33735,POINT (-87.687011 41.88004),60612-20201215
60642,12/28/2020,28,551,28,551,0.028,0,0,0,19716,POINT (-87.657821 41.899935),60642-20201228
60608,12/21/2020,98,342,98,342,0.004,0,0,0,80059,POINT (-87.670366 41.849879),60608-20201221
60632,12/18/2020,22,37,22,37,0,0,0,0,89857,POINT (-87.711251 41.810038),60632-20201218
60652,12/17/2020,12,13,12,13,0,0,0,0,43447,POINT (-87.714238 41.745398),60652-20201217
60602,01/09/2021,4,78,0,64,0.056,4,14,0.012,1145,POINT (-87.628309 41.883136),60602-20210109
60827,01/29/2021,5,75,4,64,0.002,1,11,0,28483,POINT (-87.633087 41.650765),60827-20210129
60707,12/31/2020,6,120,6,120,0.003,0,0,0,43093,POINT (-87.808283 41.921777),60707-20201231
60629,12/20/2020,20,122,20,122,0.001,0,0,0,110029,POINT (-87.711565 41.777061),60629-20201220
60642,01/15/2021,58,1603,47,1099,0.056,11,504,0.026,19716,POINT (-87.657821 41.899935),60642-20210115
60605,12/26/2020,9,1217,9,1217,0.042,0,0,0,29060,POINT (-87.623449 41.867824),60605-20201226
60625,01/21/2021,391,3932,303,3045,0.038,88,887,0.011,79444,POINT (-87.701816 41.971155),60625-20210121
60638,01/11/2021,64,1025,22,813,0.014,42,212,0.004,58669,POINT (-87.771902 41.787032),60638-20210111
60631,12/20/2020,25,207,25,207,0.007,0,0,0,29529,POINT (-87.813371 41.995019),60631-20201220
60624,01/11/2021,19,267,12,235,0.007,7,32,0.001,34892,POINT (-87.722735 41.879417),60624-20210111
60623,12/30/2020,54,356,54,356,0.004,0,0,0,81283,POINT (-87.717446 41.850321),60623-20201230
60611,01/03/2021,23,2074,23,2074,0.062,0,0,0,33224,POINT (-87.620291 41.894734),60611-20210103
60610,01/08/2021,273,1568,102,1289,0.032,171,279,0.007,40548,POINT (-87.63581 41.90455),60610-20210108
60707,12/21/2020,13,42,13,42,0.001,0,0,0,43093,POINT (-87.808283 41.921777),60707-20201221
60633,01/12/2021,7,113,4,94,0.007,3,19,0.001,12689,POINT (-87.556037 41.653147),60633-20210112
60602,12/28/2020,4,34,4,34,0.03,0,0,0,1145,POINT (-87.628309 41.883136),60602-20201228
60607,12/30/2020,172,1351,172,1351,0.046,0,0,0,29293,POINT (-87.652727 41.876104),60607-20201230
60661,01/26/2021,44,1370,27,887,0.086,17,483,0.047,10354,POINT (-87.644283 41.882786),60661-20210126
60624,01/28/2021,81,899,69,744,0.021,12,155,0.004,34892,POINT (-87.722735 41.879417),60624-20210128
60613,01/12/2021,362,2806,252,2137,0.042,110,669,0.013,50761,POINT (-87.661343 41.953742),60613-20210112
60651,01/10/2021,9,486,6,439,0.007,3,47,0.001,63492,POINT (-87.741017 41.901964),60651-20210110
60641,01/26/2021,177,3237,121,2530,0.036,56,707,0.01,69880,POINT (-87.746791 41.946682),60641-20210126
60614,12/30/2020,141,1754,141,1754,0.024,0,0,0,71954,POINT (-87.652064 41.922605),60614-20201230
60636,01/03/2021,2,90,2,90,0.003,0,0,0,30024,POINT (-87.668597 41.77599),60636-20210103
60647,01/03/2021,20,1412,20,1412,0.016,0,0,0,87633,POINT (-87.701101 41.921058),60647-20210103
60645,01/06/2021,87,1043,80,1032,0.022,7,11,0,47270,POINT (-87.695049 42.008927),60645-20210106
Unknown,02/03/2021,61,1073,29,880,0,32,193,0,0,,Unknown-20210203
60661,12/21/2020,56,270,56,270,0.026,0,0,0,10354,POINT (-87.644283 41.882786),60661-20201221
60609,12/17/2020,9,9,9,9,0,0,0,0,60939,POINT (-87.653382 41.812017),60609-20201217
60618,01/02/2021,45,1460,45,1460,0.015,0,0,0,94907,POINT (-87.703343 41.946699),60618-20210102
60631,01/11/2021,58,1228,19,964,0.033,39,264,0.009,29529,POINT (-87.813371 41.995019),60631-20210111
60613,12/22/2020,119,680,119,680,0.013,0,0,0,50761,POINT (-87.661343 41.953742),60613-20201222
60614,12/23/2020,100,1253,100,1253,0.017,0,0,0,71954,POINT (-87.652064 41.922605),60614-20201223
60637,12/27/2020,0,363,0,363,0.008,0,0,0,47300,POINT (-87.604053 41.780991),60637-20201227
60617,01/29/2021,378,3439,356,2964,0.035,22,475,0.006,83553,POINT (-87.556897 41.721257),60617-20210129
60631,12/31/2020,16,471,16,471,0.016,0,0,0,29529,POINT (-87.813371 41.995019),60631-20201231
60609,01/28/2021,186,2173,161,1785,0.029,25,388,0.006,60939,POINT (-87.653382 41.812017),60609-20210128
60616,12/22/2020,106,540,106,540,0.01,0,0,0,54197,POINT (-87.629531 41.844869),60616-20201222
60633,01/27/2021,31,324,27,261,0.021,4,63,0.005,12689,POINT (-87.556037 41.653147),60633-20210127
60641,12/25/2020,0,429,0,429,0.006,0,0,0,69880,POINT (-87.746791 41.946682),60641-20201225
60602,01/14/2021,8,107,6,77,0.067,2,30,0.026,1145,POINT (-87.628309 41.883136),60602-20210114
60605,01/02/2021,19,1568,19,1568,0.054,0,0,0,29060,POINT (-87.623449 41.867824),60605-20210102
60643,01/14/2021,51,1474,46,1177,0.024,5,297,0.006,48887,POINT (-87.662381 41.700445),60643-20210114
60624,01/31/2021,6,1045,6,878,0.025,0,167,0.005,34892,POINT (-87.722735 41.879417),60624-20210131
60606,02/25/2021,32,972,9,610,0.186,23,362,0.11,3287,POINT (-87.63676 41.882634),60606-20210225
60649,01/13/2021,118,914,102,817,0.018,16,97,0.002,46633,POINT (-87.571522 41.762202),60649-20210113
60626,12/17/2020,24,25,24,25,0,0,0,0,50544,POINT (-87.669834 42.009469),60626-20201217
60613,01/31/2021,65,6058,56,4587,0.09,9,1471,0.029,50761,POINT (-87.661343 41.953742),60613-20210131
60640,01/09/2021,129,2753,54,2427,0.035,75,326,0.005,69363,POINT (-87.662232 41.971888),60640-20210109
60827,01/14/2021,3,30,2,25,0.001,1,5,0,28483,POINT (-87.633087 41.650765),60827-20210114
60624,01/10/2021,3,248,1,223,0.006,2,25,0.001,34892,POINT (-87.722735 41.879417),60624-20210110
60636,12/19/2020,1,9,1,9,0,0,0,0,30024,POINT (-87.668597 41.77599),60636-20201219
60616,12/16/2020,3,3,3,3,0,0,0,0,54197,POINT (-87.629531 41.844869),60616-20201216
60633,12/15/2020,0,0,0,0,0,0,0,0,12689,POINT (-87.556037 41.653147),60633-20201215
60616,01/12/2021,146,2088,55,1544,0.028,91,544,0.01,54197,POINT (-87.629531 41.844869),60616-20210112
60633,01/05/2021,9,68,9,68,0.005,0,0,0,12689,POINT (-87.556037 41.653147),60633-20210105
60606,12/24/2020,2,90,2,90,0.027,0,0,0,3287,POINT (-87.63676 41.882634),60606-20201224
60632,01/09/2021,36,689,26,640,0.007,10,49,0.001,89857,POINT (-87.711251 41.810038),60632-20210109
60660,01/04/2021,92,724,88,720,0.016,4,4,0,44498,POINT (-87.666362 41.991062),60660-20210104
60632,12/25/2020,0,154,0,154,0.002,0,0,0,89857,POINT (-87.711251 41.810038),60632-20201225
60606,02/18/2021,29,838,12,567,0.172,17,271,0.082,3287,POINT (-87.63676 41.882634),60606-20210218
60616,01/27/2021,275,4017,245,2992,0.055,30,1025,0.019,54197,POINT (-87.629531 41.844869),60616-20210127
60630,01/12/2021,107,1573,75,1229,0.022,32,344,0.006,56433,POINT (-87.759611 41.971261),60630-20210112
60651,01/23/2021,49,1220,46,1028,0.016,3,192,0.003,63492,POINT (-87.741017 41.901964),60651-20210123
60613,01/07/2021,152,1723,71,1605,0.032,81,118,0.002,50761,POINT (-87.661343 41.953742),60613-20210107
60633,02/16/2021,14,911,5,726,0.057,9,185,0.015,12689,POINT (-87.556037 41.653147),60633-20210216
60657,01/13/2021,237,4763,124,3421,0.048,113,1342,0.019,70958,POINT (-87.658216 41.939715),60657-20210113
60629,01/17/2021,9,1527,6,1258,0.011,3,269,0.002,110029,POINT (-87.711565 41.777061),60629-20210117
60653,12/30/2020,48,390,48,390,0.012,0,0,0,33154,POINT (-87.611244 41.819261),60653-20201230
60638,01/19/2021,101,1562,63,1185,0.02,38,377,0.006,58669,POINT (-87.771902 41.787032),60638-20210119
60639,01/11/2021,79,968,51,841,0.01,28,127,0.001,88204,POINT (-87.75531 41.920609),60639-20210111
60628,01/07/2021,44,470,28,452,0.007,16,18,0,64254,POINT (-87.621537 41.694192),60628-20210107
60609,12/27/2020,0,182,0,182,0.003,0,0,0,60939,POINT (-87.653382 41.812017),60609-20201227
60612,12/25/2020,0,523,0,523,0.016,0,0,0,33735,POINT (-87.687011 41.88004),60612-20201225
60611,12/15/2020,0,0,0,0,0,0,0,0,33224,POINT (-87.620291 41.894734),60611-20201215
60666,12/20/2020,0,0,0,0,0,0,0,0,0,POINT (-87.896371 41.979511),60666-20201220
60622,12/20/2020,54,752,54,752,0.014,0,0,0,53294,POINT (-87.681818 41.902762),60622-20201220
60655,01/01/2021,0,530,0,530,0.019,0,0,0,28569,POINT (-87.701434 41.696456),60655-20210101
60652,01/05/2021,36,471,35,469,0.011,1,2,0,43447,POINT (-87.714238 41.745398),60652-20210105
60628,01/20/2021,137,1050,109,877,0.014,28,173,0.003,64254,POINT (-87.621537 41.694192),60628-20210120
60632,01/13/2021,61,881,41,751,0.008,20,130,0.001,89857,POINT (-87.711251 41.810038),60632-20210113
60636,01/02/2021,4,88,4,88,0.003,0,0,0,30024,POINT (-87.668597 41.77599),60636-20210102
60614,12/16/2020,3,4,3,4,0,0,0,0,71954,POINT (-87.652064 41.922605),60614-20201216
60652,12/23/2020,30,146,30,146,0.003,0,0,0,43447,POINT (-87.714238 41.745398),60652-20201223
60616,12/21/2020,93,434,93,434,0.008,0,0,0,54197,POINT (-87.629531 41.844869),60616-20201221
60606,12/19/2020,13,49,13,49,0.015,0,0,0,3287,POINT (-87.63676 41.882634),60606-20201219
60631,01/10/2021,18,1170,1,945,0.032,17,225,0.008,29529,POINT (-87.813371 41.995019),60631-20210110
60644,01/27/2021,84,1549,70,1339,0.029,14,210,0.005,46591,POINT (-87.756863 41.881113),60644-20210127
60608,01/01/2021,0,912,0,912,0.011,0,0,0,80059,POINT (-87.670366 41.849879),60608-20210101
60638,01/06/2021,37,705,31,692,0.012,6,13,0,58669,POINT (-87.771902 41.787032),60638-20210106
60619,01/15/2021,43,875,39,766,0.013,4,109,0.002,61207,POINT (-87.60569 41.744737),60619-20210115
60646,12/24/2020,5,309,5,309,0.011,0,0,0,28569,POINT (-87.761826 41.993931),60646-20201224
60645,01/18/2021,57,1913,43,1625,0.034,14,288,0.006,47270,POINT (-87.695049 42.008927),60645-20210118
60652,01/24/2021,12,1254,12,1011,0.023,0,243,0.006,43447,POINT (-87.714238 41.745398),60652-20210124
60643,01/06/2021,150,702,130,675,0.014,20,27,0.001,48887,POINT (-87.662381 41.700445),60643-20210106
60661,12/29/2020,33,406,33,406,0.039,0,0,0,10354,POINT (-87.644283 41.882786),60661-20201229
60601,12/18/2020,65,96,65,96,0.006,0,0,0,15083,POINT (-87.622844 41.886262),60601-20201218
60623,12/25/2020,0,155,0,155,0.002,0,0,0,81283,POINT (-87.717446 41.850321),60623-20201225
60641,12/18/2020,93,144,93,144,0.002,0,0,0,69880,POINT (-87.746791 41.946682),60641-20201218
60628,01/25/2021,108,1459,88,1248,0.019,20,211,0.003,64254,POINT (-87.621537 41.694192),60628-20210125
60617,12/17/2020,24,25,24,25,0,0,0,0,83553,POINT (-87.556897 41.721257),60617-20201217
60620,12/29/2020,32,192,32,192,0.003,0,0,0,67711,POINT (-87.651656 41.740873),60620-20201229
60641,01/04/2021,110,827,110,827,0.012,0,0,0,69880,POINT (-87.746791 41.946682),60641-20210104
60631,01/25/2021,109,2328,82,1881,0.064,27,447,0.015,29529,POINT (-87.813371 41.995019),60631-20210125
60637,01/25/2021,182,3120,137,2401,0.051,45,719,0.015,47300,POINT (-87.604053 41.780991),60637-20210125
60649,12/17/2020,13,13,13,13,0,0,0,0,46633,POINT (-87.571522 41.762202),60649-20201217
60626,01/07/2021,102,1195,77,1150,0.023,25,45,0.001,50544,POINT (-87.669834 42.009469),60626-20210107
60641,01/19/2021,115,2199,74,1698,0.024,41,501,0.007,69880,POINT (-87.746791 41.946682),60641-20210119
60657,12/26/2020,50,1500,50,1500,0.021,0,0,0,70958,POINT (-87.658216 41.939715),60657-20201226
Unknown,01/08/2021,9,139,4,132,0,5,7,0,0,,Unknown-20210108
60607,01/21/2021,212,4011,155,2704,0.092,57,1307,0.045,29293,POINT (-87.652727 41.876104),60607-20210121
60606,02/01/2021,16,515,11,366,0.111,5,149,0.045,3287,POINT (-87.63676 41.882634),60606-20210201
60630,01/07/2021,115,1111,56,1028,0.018,59,83,0.001,56433,POINT (-87.759611 41.971261),60630-20210107
60606,01/25/2021,22,401,16,273,0.083,6,128,0.039,3287,POINT (-87.63676 41.882634),60606-20210125
60602,12/17/2020,1,1,1,1,0.001,0,0,0,1145,POINT (-87.628309 41.883136),60602-20201217
60609,01/13/2021,62,889,33,724,0.012,29,165,0.003,60939,POINT (-87.653382 41.812017),60609-20210113
60655,12/23/2020,21,366,21,366,0.013,0,0,0,28569,POINT (-87.701434 41.696456),60655-20201223
60601,01/19/2021,45,1091,23,739,0.049,22,352,0.023,15083,POINT (-87.622844 41.886262),60601-20210119
60707,01/19/2021,95,433,81,350,0.008,14,83,0.002,43093,POINT (-87.808283 41.921777),60707-20210119
60624,12/26/2020,1,59,1,59,0.002,0,0,0,34892,POINT (-87.722735 41.879417),60624-20201226
60609,01/18/2021,53,1113,33,905,0.015,20,208,0.003,60939,POINT (-87.653382 41.812017),60609-20210118
60707,01/11/2021,17,226,7,191,0.004,10,35,0.001,43093,POINT (-87.808283 41.921777),60707-20210111
60646,01/10/2021,10,861,6,694,0.024,4,167,0.006,28569,POINT (-87.761826 41.993931),60646-20210110
60621,12/17/2020,5,5,5,5,0,0,0,0,28018,POINT (-87.638812 41.776931),60621-20201217
60641,01/29/2021,214,3917,190,3101,0.044,24,816,0.012,69880,POINT (-87.746791 41.946682),60641-20210129
60619,12/24/2020,10,121,10,121,0.002,0,0,0,61207,POINT (-87.60569 41.744737),60619-20201224
60607,12/20/2020,31,542,31,542,0.019,0,0,0,29293,POINT (-87.652727 41.876104),60607-20201220
60649,12/27/2020,0,122,0,122,0.003,0,0,0,46633,POINT (-87.571522 41.762202),60649-20201227
60656,01/19/2021,45,841,34,622,0.022,11,219,0.008,28218,POINT (-87.817934 41.974566),60656-20210119
60636,01/24/2021,13,477,10,413,0.014,3,64,0.002,30024,POINT (-87.668597 41.77599),60636-20210124
60661,01/25/2021,35,1326,8,860,0.083,27,466,0.045,10354,POINT (-87.644283 41.882786),60661-20210125
60647,12/27/2020,0,984,0,984,0.011,0,0,0,87633,POINT (-87.701101 41.921058),60647-20201227
60628,01/10/2021,5,562,2,512,0.008,3,50,0.001,64254,POINT (-87.621537 41.694192),60628-20210110
60610,01/04/2021,51,997,44,989,0.024,7,8,0,40548,POINT (-87.63581 41.90455),60610-20210104
60666,02/11/2021,0,22,0,20,0,0,2,0,0,POINT (-87.896371 41.979511),60666-20210211
60657,01/12/2021,371,4526,188,3297,0.046,183,1229,0.017,70958,POINT (-87.658216 41.939715),60657-20210112
60607,01/06/2021,77,1774,52,1727,0.059,25,47,0.002,29293,POINT (-87.652727 41.876104),60607-20210106
60666,01/21/2021,0,2,0,2,0,0,0,0,0,POINT (-87.896371 41.979511),60666-20210121
60640,01/12/2021,249,3320,137,2744,0.04,112,576,0.008,69363,POINT (-87.662232 41.971888),60640-20210112
60639,12/23/2020,28,203,28,203,0.002,0,0,0,88204,POINT (-87.75531 41.920609),60639-20201223
60621,01/07/2021,15,234,12,226,0.008,3,8,0,28018,POINT (-87.638812 41.776931),60621-20210107
60624,12/30/2020,21,102,21,102,0.003,0,0,0,34892,POINT (-87.722735 41.879417),60624-20201230
60622,01/08/2021,343,3205,67,2692,0.051,276,513,0.01,53294,POINT (-87.681818 41.902762),60622-20210108
60666,01/10/2021,0,0,0,0,0,0,0,0,0,POINT (-87.896371 41.979511),60666-20210110
60666,02/26/2021,2,33,0,23,0,2,10,0,0,POINT (-87.896371 41.979511),60666-20210226
60625,12/16/2020,4,4,4,4,0,0,0,0,79444,POINT (-87.701816 41.971155),60625-20201216
60606,01/20/2021,24,320,9,206,0.063,15,114,0.035,3287,POINT (-87.63676 41.882634),60606-20210120
60616,01/22/2021,227,3269,201,2391,0.044,26,878,0.016,54197,POINT (-87.629531 41.844869),60616-20210122
60623,01/26/2021,141,2069,122,1771,0.022,19,298,0.004,81283,POINT (-87.717446 41.850321),60623-20210126
60629,12/16/2020,2,2,2,2,0,0,0,0,110029,POINT (-87.711565 41.777061),60629-20201216
60616,01/17/2021,18,2493,8,1830,0.034,10,663,0.012,54197,POINT (-87.629531 41.844869),60616-20210117
60641,01/14/2021,100,1811,80,1412,0.02,20,399,0.006,69880,POINT (-87.746791 41.946682),60641-20210114
60633,02/06/2021,42,618,40,518,0.041,2,100,0.008,12689,POINT (-87.556037 41.653147),60633-20210206
60625,01/17/2021,45,3004,31,2377,0.03,14,627,0.008,79444,POINT (-87.701816 41.971155),60625-20210117
60707,12/27/2020,0,75,0,75,0.002,0,0,0,43093,POINT (-87.808283 41.921777),60707-20201227
60827,02/27/2021,14,238,12,168,0.006,2,70,0.002,28483,POINT (-87.633087 41.650765),60827-20210227
60613,12/23/2020,87,767,87,767,0.015,0,0,0,50761,POINT (-87.661343 41.953742),60613-20201223
60637,12/28/2020,14,377,14,377,0.008,0,0,0,47300,POINT (-87.604053 41.780991),60637-20201228
60827,02/09/2021,3,128,2,106,0.004,1,22,0.001,28483,POINT (-87.633087 41.650765),60827-20210209
60611,12/30/2020,88,1989,88,1989,0.06,0,0,0,33224,POINT (-87.620291 41.894734),60611-20201230
60646,01/25/2021,107,2169,81,1726,0.06,26,443,0.016,28569,POINT (-87.761826 41.993931),60646-20210125
60631,12/24/2020,6,341,6,341,0.012,0,0,0,29529,POINT (-87.813371 41.995019),60631-20201224
60707,12/25/2020,0,75,0,75,0.002,0,0,0,43093,POINT (-87.808283 41.921777),60707-20201225
60644,12/23/2020,22,78,22,78,0.002,0,0,0,46591,POINT (-87.756863 41.881113),60644-20201223
60609,01/23/2021,84,1602,79,1313,0.022,5,289,0.005,60939,POINT (-87.653382 41.812017),60609-20210123
60637,12/15/2020,0,0,0,0,0,0,0,0,47300,POINT (-87.604053 41.780991),60637-20201215
60645,01/01/2021,2,650,2,650,0.014,0,0,0,47270,POINT (-87.695049 42.008927),60645-20210101
60608,12/17/2020,35,35,35,35,0,0,0,0,80059,POINT (-87.670366 41.849879),60608-20201217
60652,12/21/2020,31,94,31,94,0.002,0,0,0,43447,POINT (-87.714238 41.745398),60652-20201221
60619,12/31/2020,23,267,23,267,0.004,0,0,0,61207,POINT (-87.60569 41.744737),60619-20201231
60827,12/20/2020,0,4,0,4,0,0,0,0,28483,POINT (-87.633087 41.650765),60827-20201220
60628,12/24/2020,10,111,10,111,0.002,0,0,0,64254,POINT (-87.621537 41.694192),60628-20201224
60656,12/18/2020,58,68,58,68,0.002,0,0,0,28218,POINT (-87.817934 41.974566),60656-20201218
60617,01/13/2021,68,913,42,739,0.009,26,174,0.002,83553,POINT (-87.556897 41.721257),60617-20210113
60611,01/16/2021,60,4974,52,3335,0.1,8,1639,0.049,33224,POINT (-87.620291 41.894734),60611-20210116
60629,01/02/2021,17,540,17,540,0.005,0,0,0,110029,POINT (-87.711565 41.777061),60629-20210102
60637,01/16/2021,105,1706,57,1285,0.027,48,421,0.009,47300,POINT (-87.604053 41.780991),60637-20210116
60661,01/13/2021,56,974,25,653,0.063,31,321,0.031,10354,POINT (-87.644283 41.882786),60661-20210113
60647,01/07/2021,208,1925,81,1754,0.02,127,171,0.002,87633,POINT (-87.701101 41.921058),60647-20210107
60609,01/08/2021,51,648,26,598,0.01,25,50,0.001,60939,POINT (-87.653382 41.812017),60609-20210108
60643,01/10/2021,10,933,2,750,0.015,8,183,0.004,48887,POINT (-87.662381 41.700445),60643-20210110
60607,02/01/2021,111,5532,77,3754,0.128,34,1778,0.061,29293,POINT (-87.652727 41.876104),60607-20210201
60607,01/03/2021,14,1452,13,1451,0.05,1,1,0,29293,POINT (-87.652727 41.876104),60607-20210103
60661,12/17/2020,41,48,41,48,0.005,0,0,0,10354,POINT (-87.644283 41.882786),60661-20201217
60633,01/15/2021,8,133,8,110,0.009,0,23,0.002,12689,POINT (-87.556037 41.653147),60633-20210115
60602,01/18/2021,8,132,6,99,0.086,2,33,0.029,1145,POINT (-87.628309 41.883136),60602-20210118
60610,01/31/2021,32,4822,30,3678,0.091,2,1144,0.028,40548,POINT (-87.63581 41.90455),60610-20210131
60620,01/11/2021,26,672,10,584,0.009,16,88,0.001,67711,POINT (-87.651656 41.740873),60620-20210111
60642,12/21/2020,73,363,73,363,0.018,0,0,0,19716,POINT (-87.657821 41.899935),60642-20201221
60827,01/26/2021,5,57,5,50,0.002,0,7,0,28483,POINT (-87.633087 41.650765),60827-20210126
60630,01/02/2021,28,679,28,679,0.012,0,0,0,56433,POINT (-87.759611 41.971261),60630-20210102
60613,12/18/2020,210,266,210,266,0.005,0,0,0,50761,POINT (-87.661343 41.953742),60613-20201218
60655,01/05/2021,36,724,31,718,0.025,5,6,0,28569,POINT (-87.701434 41.696456),60655-20210105
60618,12/29/2020,157,1171,157,1171,0.012,0,0,0,94907,POINT (-87.703343 41.946699),60618-20201229
60605,01/14/2021,97,3364,64,2194,0.075,33,1170,0.04,29060,POINT (-87.623449 41.867824),60605-20210114
60602,01/29/2021,13,268,12,212,0.185,1,56,0.049,1145,POINT (-87.628309 41.883136),60602-20210129
60614,12/19/2020,178,632,178,632,0.009,0,0,0,71954,POINT (-87.652064 41.922605),60614-20201219
60606,02/21/2021,4,877,1,576,0.175,3,301,0.092,3287,POINT (-87.63676 41.882634),60606-20210221
60636,12/23/2020,8,29,8,29,0.001,0,0,0,30024,POINT (-87.668597 41.77599),60636-20201223
60645,12/17/2020,16,22,16,22,0,0,0,0,47270,POINT (-87.695049 42.008927),60645-20201217
60613,01/16/2021,77,3304,64,2496,0.049,13,808,0.016,50761,POINT (-87.661343 41.953742),60613-20210116
60827,02/10/2021,7,135,5,111,0.004,2,24,0.001,28483,POINT (-87.633087 41.650765),60827-20210210
60626,12/23/2020,49,323,49,323,0.006,0,0,0,50544,POINT (-87.669834 42.009469),60626-20201223
60605,01/27/2021,166,4839,129,3154,0.109,37,1685,0.058,29060,POINT (-87.623449 41.867824),60605-20210127
60636,01/07/2021,15,143,12,138,0.005,3,5,0,30024,POINT (-87.668597 41.77599),60636-20210107
60660,01/27/2021,253,3628,165,2941,0.066,88,687,0.015,44498,POINT (-87.666362 41.991062),60660-20210127
60608,12/22/2020,114,456,114,456,0.006,0,0,0,80059,POINT (-87.670366 41.849879),60608-20201222
60645,12/31/2020,44,648,44,648,0.014,0,0,0,47270,POINT (-87.695049 42.008927),60645-20201231
60640,12/28/2020,84,826,84,826,0.012,0,0,0,69363,POINT (-87.662232 41.971888),60640-20201228
Unknown,02/09/2021,78,1348,34,1009,0,44,339,0,0,,Unknown-20210209
60616,12/26/2020,12,660,12,660,0.012,0,0,0,54197,POINT (-87.629531 41.844869),60616-20201226
60661,01/30/2021,15,1536,6,1004,0.097,9,532,0.051,10354,POINT (-87.644283 41.882786),60661-20210130
60656,12/25/2020,0,194,0,194,0.007,0,0,0,28218,POINT (-87.817934 41.974566),60656-20201225
60623,01/16/2021,26,1145,22,1003,0.012,4,142,0.002,81283,POINT (-87.717446 41.850321),60623-20210116
60624,12/19/2020,5,23,5,23,0.001,0,0,0,34892,POINT (-87.722735 41.879417),60624-20201219
60631,01/20/2021,123,1868,95,1482,0.05,28,386,0.013,29529,POINT (-87.813371 41.995019),60631-20210120
60646,01/21/2021,163,1720,138,1325,0.046,25,395,0.014,28569,POINT (-87.761826 41.993931),60646-20210121
60610,12/25/2020,0,644,0,644,0.016,0,0,0,40548,POINT (-87.63581 41.90455),60610-20201225
60608,12/26/2020,6,571,6,571,0.007,0,0,0,80059,POINT (-87.670366 41.849879),60608-20201226
60641,12/28/2020,44,486,44,486,0.007,0,0,0,69880,POINT (-87.746791 41.946682),60641-20201228
60645,01/23/2021,65,2484,56,2077,0.044,9,407,0.009,47270,POINT (-87.695049 42.008927),60645-20210123
60646,01/06/2021,33,628,27,622,0.022,6,6,0,28569,POINT (-87.761826 41.993931),60646-20210106
60609,12/31/2020,29,336,29,336,0.006,0,0,0,60939,POINT (-87.653382 41.812017),60609-20201231
60626,12/26/2020,2,339,2,339,0.007,0,0,0,50544,POINT (-87.669834 42.009469),60626-20201226
60614,12/26/2020,37,1321,37,1321,0.018,0,0,0,71954,POINT (-87.652064 41.922605),60614-20201226
60655,12/28/2020,18,398,18,398,0.014,0,0,0,28569,POINT (-87.701434 41.696456),60655-20201228
60601,01/02/2021,8,424,8,424,0.028,0,0,0,15083,POINT (-87.622844 41.886262),60601-20210102
60612,12/29/2020,83,668,83,668,0.02,0,0,0,33735,POINT (-87.687011 41.88004),60612-20201229
60637,12/24/2020,35,359,35,359,0.008,0,0,0,47300,POINT (-87.604053 41.780991),60637-20201224
60610,12/18/2020,160,225,160,225,0.006,0,0,0,40548,POINT (-87.63581 41.90455),60610-20201218
60632,01/19/2021,95,1217,62,1009,0.011,33,208,0.002,89857,POINT (-87.711251 41.810038),60632-20210119
60628,01/16/2021,18,771,16,667,0.01,2,104,0.002,64254,POINT (-87.621537 41.694192),60628-20210116
60623,01/11/2021,52,836,28,764,0.009,24,72,0.001,81283,POINT (-87.717446 41.850321),60623-20210111
60610,12/20/2020,24,347,24,347,0.009,0,0,0,40548,POINT (-87.63581 41.90455),60610-20201220
60636,12/29/2020,13,56,13,56,0.002,0,0,0,30024,POINT (-87.668597 41.77599),60636-20201229
60642,01/24/2021,22,2107,21,1441,0.073,1,666,0.034,19716,POINT (-87.657821 41.899935),60642-20210124
60630,12/23/2020,50,414,50,414,0.007,0,0,0,56433,POINT (-87.759611 41.971261),60630-20201223
60637,01/10/2021,30,1217,4,1004,0.021,26,213,0.005,47300,POINT (-87.604053 41.780991),60637-20210110
60610,01/21/2021,297,3048,273,2209,0.054,24,839,0.021,40548,POINT (-87.63581 41.90455),60610-20210121
60644,12/31/2020,8,213,8,213,0.005,0,0,0,46591,POINT (-87.756863 41.881113),60644-20201231
60606,01/08/2021,30,189,7,153,0.047,23,36,0.011,3287,POINT (-87.63676 41.882634),60606-20210108
60602,01/01/2021,0,44,0,44,0.038,0,0,0,1145,POINT (-87.628309 41.883136),60602-20210101
60621,12/21/2020,6,24,6,24,0.001,0,0,0,28018,POINT (-87.638812 41.776931),60621-20201221
60613,01/19/2021,155,3633,86,2674,0.053,69,959,0.019,50761,POINT (-87.661343 41.953742),60613-20210119
60655,12/19/2020,53,184,53,184,0.006,0,0,0,28569,POINT (-87.701434 41.696456),60655-20201219
60629,01/21/2021,254,2085,231,1681,0.015,23,404,0.004,110029,POINT (-87.711565 41.777061),60629-20210121
Unknown,02/24/2021,47,1962,26,1237,0,21,725,0,0,,Unknown-20210224
60605,12/30/2020,130,1507,130,1507,0.052,0,0,0,29060,POINT (-87.623449 41.867824),60605-20201230
60653,12/25/2020,0,169,0,169,0.005,0,0,0,33154,POINT (-87.611244 41.819261),60653-20201225
60622,12/24/2020,25,1362,25,1362,0.026,0,0,0,53294,POINT (-87.681818 41.902762),60622-20201224
60827,12/25/2020,0,7,0,7,0,0,0,0,28483,POINT (-87.633087 41.650765),60827-20201225
60638,12/17/2020,22,22,22,22,0,0,0,0,58669,POINT (-87.771902 41.787032),60638-20201217
60613,01/02/2021,31,1237,31,1237,0.024,0,0,0,50761,POINT (-87.661343 41.953742),60613-20210102
60617,12/19/2020,15,72,15,72,0.001,0,0,0,83553,POINT (-87.556897 41.721257),60617-20201219
60643,12/24/2020,10,312,10,312,0.006,0,0,0,48887,POINT (-87.662381 41.700445),60643-20201224
60644,01/14/2021,32,923,24,857,0.018,8,66,0.001,46591,POINT (-87.756863 41.881113),60644-20210114
Unknown,01/23/2021,25,691,25,605,0,0,86,0,0,,Unknown-20210123
60707,01/07/2021,15,169,8,160,0.004,7,9,0,43093,POINT (-87.808283 41.921777),60707-20210107
60637,01/21/2021,253,2562,209,1961,0.041,44,601,0.013,47300,POINT (-87.604053 41.780991),60637-20210121
60639,12/28/2020,32,249,32,249,0.003,0,0,0,88204,POINT (-87.75531 41.920609),60639-20201228
60644,12/26/2020,3,85,3,85,0.002,0,0,0,46591,POINT (-87.756863 41.881113),60644-20201226
60623,01/21/2021,133,1518,117,1282,0.016,16,236,0.003,81283,POINT (-87.717446 41.850321),60623-20210121
60632,01/30/2021,163,3023,147,2538,0.028,16,485,0.005,89857,POINT (-87.711251 41.810038),60632-20210130
60827,02/22/2021,6,191,4,134,0.005,2,57,0.002,28483,POINT (-87.633087 41.650765),60827-20210222
60617,01/03/2021,7,375,7,375,0.004,0,0,0,83553,POINT (-87.556897 41.721257),60617-20210103
60642,12/31/2020,28,699,28,699,0.035,0,0,0,19716,POINT (-87.657821 41.899935),60642-20201231
60666,12/24/2020,0,0,0,0,0,0,0,0,0,POINT (-87.896371 41.979511),60666-20201224
60661,01/18/2021,25,1089,13,735,0.071,12,354,0.034,10354,POINT (-87.644283 41.882786),60661-20210118
Unknown,01/12/2021,38,197,29,175,0,9,22,0,0,,Unknown-20210112
60651,01/04/2021,29,281,27,279,0.004,2,2,0,63492,POINT (-87.741017 41.901964),60651-20210104
60606,01/03/2021,0,129,0,129,0.039,0,0,0,3287,POINT (-87.63676 41.882634),60606-20210103
60620,12/17/2020,16,16,16,16,0,0,0,0,67711,POINT (-87.651656 41.740873),60620-20201217
60640,12/17/2020,41,44,41,44,0.001,0,0,0,69363,POINT (-87.662232 41.971888),60640-20201217
60639,01/07/2021,61,668,35,631,0.007,26,37,0,88204,POINT (-87.75531 41.920609),60639-20210107
60637,12/19/2020,41,122,41,122,0.003,0,0,0,47300,POINT (-87.604053 41.780991),60637-20201219
60642,01/22/2021,80,2040,70,1379,0.07,10,661,0.034,19716,POINT (-87.657821 41.899935),60642-20210122
60638,01/01/2021,2,539,2,539,0.009,0,0,0,58669,POINT (-87.771902 41.787032),60638-20210101
60620,01/01/2021,0,257,0,257,0.004,0,0,0,67711,POINT (-87.651656 41.740873),60620-20210101
60666,01/25/2021,1,3,1,3,0,0,0,0,0,POINT (-87.896371 41.979511),60666-20210125
60666,02/22/2021,0,26,0,23,0,0,3,0,0,POINT (-87.896371 41.979511),60666-20210222
60637,01/20/2021,189,2309,134,1752,0.037,55,557,0.012,47300,POINT (-87.604053 41.780991),60637-20210120
60661,01/08/2021,91,721,22,592,0.057,69,129,0.012,10354,POINT (-87.644283 41.882786),60661-20210108
60647,12/31/2020,60,1345,60,1345,0.015,0,0,0,87633,POINT (-87.701101 41.921058),60647-20201231
60827,01/21/2021,3,45,3,39,0.001,0,6,0,28483,POINT (-87.633087 41.650765),60827-20210121
60666,01/14/2021,0,1,0,1,0,0,0,0,0,POINT (-87.896371 41.979511),60666-20210114
60660,01/12/2021,119,1992,83,1721,0.039,36,271,0.006,44498,POINT (-87.666362 41.991062),60660-20210112
60623,12/15/2020,0,0,0,0,0,0,0,0,81283,POINT (-87.717446 41.850321),60623-20201215
60630,01/24/2021,30,2699,25,2107,0.037,5,592,0.01,56433,POINT (-87.759611 41.971261),60630-20210124
60633,01/20/2021,21,187,16,150,0.012,5,37,0.003,12689,POINT (-87.556037 41.653147),60633-20210120
60645,01/13/2021,100,1655,65,1403,0.03,35,252,0.005,47270,POINT (-87.695049 42.008927),60645-20210113
60619,01/12/2021,50,606,37,525,0.009,13,81,0.001,61207,POINT (-87.60569 41.744737),60619-20210112
60624,01/03/2021,1,126,1,126,0.004,0,0,0,34892,POINT (-87.722735 41.879417),60624-20210103
60652,01/09/2021,24,609,15,557,0.013,9,52,0.001,43447,POINT (-87.714238 41.745398),60652-20210109
60642,01/05/2021,59,821,52,810,0.041,7,11,0.001,19716,POINT (-87.657821 41.899935),60642-20210105
60640,01/18/2021,133,4230,68,3436,0.05,65,794,0.011,69363,POINT (-87.662232 41.971888),60640-20210118
60611,12/26/2020,38,1654,38,1654,0.05,0,0,0,33224,POINT (-87.620291 41.894734),60611-20201226
60605,01/03/2021,33,1601,29,1597,0.055,4,4,0,29060,POINT (-87.623449 41.867824),60605-20210103
60616,01/02/2021,11,931,11,931,0.017,0,0,0,54197,POINT (-87.629531 41.844869),60616-20210102
60624,01/20/2021,53,523,40,442,0.013,13,81,0.002,34892,POINT (-87.722735 41.879417),60624-20210120
60616,12/31/2020,35,918,35,918,0.017,0,0,0,54197,POINT (-87.629531 41.844869),60616-20201231
60606,02/04/2021,29,569,24,412,0.125,5,157,0.048,3287,POINT (-87.63676 41.882634),60606-20210204
60656,01/09/2021,33,534,8,417,0.015,25,117,0.004,28218,POINT (-87.817934 41.974566),60656-20210109
60629,01/06/2021,46,705,40,696,0.006,6,9,0,110029,POINT (-87.711565 41.777061),60629-20210106
60601,12/31/2020,14,415,14,415,0.028,0,0,0,15083,POINT (-87.622844 41.886262),60601-20201231
60656,01/26/2021,53,1205,36,921,0.033,17,284,0.01,28218,POINT (-87.817934 41.974566),60656-20210126
60610,12/30/2020,97,876,97,876,0.022,0,0,0,40548,POINT (-87.63581 41.90455),60610-20201230
60827,01/09/2021,1,19,1,17,0.001,0,2,0,28483,POINT (-87.633087 41.650765),60827-20210109
60644,12/19/2020,7,25,7,25,0.001,0,0,0,46591,POINT (-87.756863 41.881113),60644-20201219
60660,12/25/2020,0,342,0,342,0.008,0,0,0,44498,POINT (-87.666362 41.991062),60660-20201225
60607,01/18/2021,88,3391,46,2362,0.081,42,1029,0.035,29293,POINT (-87.652727 41.876104),60607-20210118
60633,12/26/2020,0,26,0,26,0.002,0,0,0,12689,POINT (-87.556037 41.653147),60633-20201226
60617,12/29/2020,49,291,49,291,0.003,0,0,0,83553,POINT (-87.556897 41.721257),60617-20201229
60631,12/29/2020,44,407,44,407,0.014,0,0,0,29529,POINT (-87.813371 41.995019),60631-20201229
60630,01/19/2021,87,2099,55,1615,0.029,32,484,0.009,56433,POINT (-87.759611 41.971261),60630-20210119
60623,01/31/2021,13,2897,11,2425,0.03,2,472,0.006,81283,POINT (-87.717446 41.850321),60623-20210131
60643,12/22/2020,57,272,57,272,0.006,0,0,0,48887,POINT (-87.662381 41.700445),60643-20201222
60605,01/10/2021,62,2650,7,1956,0.067,55,694,0.024,29060,POINT (-87.623449 41.867824),60605-20210110
60611,01/12/2021,262,4572,87,3073,0.092,175,1499,0.045,33224,POINT (-87.620291 41.894734),60611-20210112
60616,02/01/2021,139,4941,100,3778,0.07,39,1163,0.021,54197,POINT (-87.629531 41.844869),60616-20210201
60622,01/25/2021,165,6177,99,4417,0.083,66,1760,0.033,53294,POINT (-87.681818 41.902762),60622-20210125
60607,12/17/2020,100,105,100,105,0.004,0,0,0,29293,POINT (-87.652727 41.876104),60607-20201217
60633,02/03/2021,33,497,31,417,0.033,2,80,0.006,12689,POINT (-87.556037 41.653147),60633-20210203
60622,01/04/2021,103,2252,90,2238,0.042,13,14,0,53294,POINT (-87.681818 41.902762),60622-20210104
60633,02/21/2021,6,1078,5,804,0.063,1,274,0.022,12689,POINT (-87.556037 41.653147),60633-20210221
60649,01/18/2021,56,1077,46,954,0.02,10,123,0.003,46633,POINT (-87.571522 41.762202),60649-20210118
60636,01/09/2021,7,173,5,160,0.005,2,13,0,30024,POINT (-87.668597 41.77599),60636-20210109
60660,01/13/2021,103,2095,63,1784,0.04,40,311,0.007,44498,POINT (-87.666362 41.991062),60660-20210113
60625,01/13/2021,195,2660,93,2079,0.026,102,581,0.007,79444,POINT (-87.701816 41.971155),60625-20210113
60613,12/30/2020,128,1172,128,1172,0.023,0,0,0,50761,POINT (-87.661343 41.953742),60613-20201230
60640,01/01/2021,2,1195,2,1195,0.017,0,0,0,69363,POINT (-87.662232 41.971888),60640-20210101
60651,01/19/2021,40,821,22,681,0.011,18,140,0.002,63492,POINT (-87.741017 41.901964),60651-20210119
60646,12/20/2020,14,170,14,170,0.006,0,0,0,28569,POINT (-87.761826 41.993931),60646-20201220
60628,12/31/2020,16,231,16,231,0.004,0,0,0,64254,POINT (-87.621537 41.694192),60628-20201231
60605,01/31/2021,31,5379,24,3581,0.123,7,1798,0.062,29060,POINT (-87.623449 41.867824),60605-20210131
60621,01/03/2021,0,180,0,180,0.006,0,0,0,28018,POINT (-87.638812 41.776931),60621-20210103
60617,01/21/2021,273,1740,249,1437,0.017,24,303,0.004,83553,POINT (-87.556897 41.721257),60617-20210121
60623,01/06/2021,129,627,124,621,0.008,5,6,0,81283,POINT (-87.717446 41.850321),60623-20210106
60618,12/25/2020,0,918,0,918,0.01,0,0,0,94907,POINT (-87.703343 41.946699),60618-20201225
60609,01/03/2021,4,345,4,345,0.006,0,0,0,60939,POINT (-87.653382 41.812017),60609-20210103
60653,01/09/2021,74,663,56,589,0.018,18,74,0.002,33154,POINT (-87.611244 41.819261),60653-20210109
60637,01/07/2021,85,1023,45,940,0.02,40,83,0.002,47300,POINT (-87.604053 41.780991),60637-20210107
60616,02/03/2021,266,5529,218,4209,0.078,48,1320,0.024,54197,POINT (-87.629531 41.844869),60616-20210203
60632,12/29/2020,54,242,54,242,0.003,0,0,0,89857,POINT (-87.711251 41.810038),60632-20201229
60610,01/26/2021,220,3924,124,2912,0.072,96,1012,0.025,40548,POINT (-87.63581 41.90455),60610-20210126
60641,01/12/2021,134,1559,91,1238,0.018,43,321,0.005,69880,POINT (-87.746791 41.946682),60641-20210112
60601,01/15/2021,32,977,21,679,0.045,11,298,0.02,15083,POINT (-87.622844 41.886262),60601-20210115
60625,01/10/2021,21,2112,13,1807,0.023,8,305,0.004,79444,POINT (-87.701816 41.971155),60625-20210110
60628,01/12/2021,44,629,30,553,0.009,14,76,0.001,64254,POINT (-87.621537 41.694192),60628-20210112
60619,12/15/2020,0,0,0,0,0,0,0,0,61207,POINT (-87.60569 41.744737),60619-20201215
60652,01/15/2021,29,857,23,718,0.017,6,139,0.003,43447,POINT (-87.714238 41.745398),60652-20210115
60605,01/08/2021,285,2408,57,1919,0.066,228,489,0.017,29060,POINT (-87.623449 41.867824),60605-20210108
60657,12/16/2020,10,10,10,10,0,0,0,0,70958,POINT (-87.658216 41.939715),60657-20201216
60617,12/24/2020,10,199,10,199,0.002,0,0,0,83553,POINT (-87.556897 41.721257),60617-20201224
60629,12/22/2020,47,215,47,215,0.002,0,0,0,110029,POINT (-87.711565 41.777061),60629-20201222
60610,12/16/2020,2,2,2,2,0,0,0,0,40548,POINT (-87.63581 41.90455),60610-20201216
60643,12/19/2020,42,128,42,128,0.003,0,0,0,48887,POINT (-87.662381 41.700445),60643-20201219
60633,12/23/2020,4,23,4,23,0.002,0,0,0,12689,POINT (-87.556037 41.653147),60633-20201223
60609,01/16/2021,82,1050,77,868,0.014,5,182,0.003,60939,POINT (-87.653382 41.812017),60609-20210116
60624,12/23/2020,8,57,8,57,0.002,0,0,0,34892,POINT (-87.722735 41.879417),60624-20201223
60616,02/04/2021,418,5947,339,4548,0.084,79,1399,0.026,54197,POINT (-87.629531 41.844869),60616-20210204
60614,12/24/2020,30,1283,30,1283,0.018,0,0,0,71954,POINT (-87.652064 41.922605),60614-20201224
60626,01/06/2021,89,1093,72,1073,0.021,17,20,0,50544,POINT (-87.669834 42.009469),60626-20210106
60660,01/18/2021,63,2406,35,2035,0.046,28,371,0.008,44498,POINT (-87.666362 41.991062),60660-20210118
Unknown,01/06/2021,13,120,13,120,0,0,0,0,0,,Unknown-20210106
Unknown,12/24/2020,3,38,3,38,0,0,0,0,0,,Unknown-20201224
60666,02/21/2021,0,26,0,23,0,0,3,0,0,POINT (-87.896371 41.979511),60666-20210221
60629,01/23/2021,85,2358,79,1938,0.018,6,420,0.004,110029,POINT (-87.711565 41.777061),60629-20210123
60632,01/23/2021,92,1724,90,1448,0.016,2,276,0.003,89857,POINT (-87.711251 41.810038),60632-20210123
60646,12/17/2020,13,13,13,13,0,0,0,0,28569,POINT (-87.761826 41.993931),60646-20201217
60617,01/20/2021,147,1467,114,1188,0.014,33,279,0.003,83553,POINT (-87.556897 41.721257),60617-20210120
60641,12/26/2020,13,442,13,442,0.006,0,0,0,69880,POINT (-87.746791 41.946682),60641-20201226
60618,01/11/2021,220,2846,79,2225,0.023,141,621,0.007,94907,POINT (-87.703343 41.946699),60618-20210111
60631,01/01/2021,0,471,0,471,0.016,0,0,0,29529,POINT (-87.813371 41.995019),60631-20210101
60632,01/01/2021,1,404,1,404,0.004,0,0,0,89857,POINT (-87.711251 41.810038),60632-20210101
60626,12/20/2020,8,170,8,170,0.003,0,0,0,50544,POINT (-87.669834 42.009469),60626-20201220
60620,12/18/2020,38,54,38,54,0.001,0,0,0,67711,POINT (-87.651656 41.740873),60620-20201218
60620,01/08/2021,83,616,56,555,0.008,27,61,0.001,67711,POINT (-87.651656 41.740873),60620-20210108
60636,12/20/2020,0,9,0,9,0,0,0,0,30024,POINT (-87.668597 41.77599),60636-20201220
60612,12/21/2020,105,326,105,326,0.01,0,0,0,33735,POINT (-87.687011 41.88004),60612-20201221
60623,01/17/2021,7,1152,7,1010,0.012,0,142,0.002,81283,POINT (-87.717446 41.850321),60623-20210117
60601,12/26/2020,10,318,10,318,0.021,0,0,0,15083,POINT (-87.622844 41.886262),60601-20201226
60644,01/10/2021,7,682,4,652,0.014,3,30,0.001,46591,POINT (-87.756863 41.881113),60644-20210110
60827,12/29/2020,1,8,1,8,0,0,0,0,28483,POINT (-87.633087 41.650765),60827-20201229
60619,01/07/2021,32,423,23,407,0.007,9,16,0,61207,POINT (-87.60569 41.744737),60619-20210107
60646,01/18/2021,48,1362,34,1036,0.036,14,326,0.011,28569,POINT (-87.761826 41.993931),60646-20210118
60620,01/06/2021,139,481,134,467,0.007,5,14,0,67711,POINT (-87.651656 41.740873),60620-20210106
60610,01/09/2021,105,1673,23,1312,0.032,82,361,0.009,40548,POINT (-87.63581 41.90455),60610-20210109
60666,02/16/2021,0,23,0,21,0,0,2,0,0,POINT (-87.896371 41.979511),60666-20210216
60622,01/16/2021,83,4726,77,3430,0.064,6,1296,0.024,53294,POINT (-87.681818 41.902762),60622-20210116
60660,01/07/2021,652,1533,603,1467,0.033,49,66,0.001,44498,POINT (-87.666362 41.991062),60660-20210107
60613,01/26/2021,377,5083,241,3792,0.075,136,1291,0.025,50761,POINT (-87.661343 41.953742),60613-20210126
Unknown,01/16/2021,33,379,29,338,0,4,41,0,0,,Unknown-20210116
60624,12/18/2020,9,18,9,18,0.001,0,0,0,34892,POINT (-87.722735 41.879417),60624-20201218
60623,12/16/2020,2,2,2,2,0,0,0,0,81283,POINT (-87.717446 41.850321),60623-20201216
60628,12/17/2020,7,7,7,7,0,0,0,0,64254,POINT (-87.621537 41.694192),60628-20201217
60660,12/28/2020,36,383,36,383,0.009,0,0,0,44498,POINT (-87.666362 41.991062),60660-20201228
60605,12/17/2020,123,134,123,134,0.005,0,0,0,29060,POINT (-87.623449 41.867824),60605-20201217
60642,01/13/2021,85,1508,35,1031,0.052,50,477,0.024,19716,POINT (-87.657821 41.899935),60642-20210113
60606,02/09/2021,24,646,15,468,0.142,9,178,0.054,3287,POINT (-87.63676 41.882634),60606-20210209
60608,01/09/2021,156,1628,94,1396,0.017,62,232,0.003,80059,POINT (-87.670366 41.849879),60608-20210109
60640,12/21/2020,140,471,140,471,0.007,0,0,0,69363,POINT (-87.662232 41.971888),60640-20201221
60625,12/24/2020,20,627,20,627,0.008,0,0,0,79444,POINT (-87.701816 41.971155),60625-20201224
60617,01/08/2021,72,655,43,591,0.007,29,64,0.001,83553,POINT (-87.556897 41.721257),60617-20210108
60601,01/27/2021,66,1596,52,1137,0.075,14,459,0.03,15083,POINT (-87.622844 41.886262),60601-20210127
60655,12/29/2020,42,440,42,440,0.015,0,0,0,28569,POINT (-87.701434 41.696456),60655-20201229
60646,01/28/2021,175,2603,155,2083,0.073,20,520,0.018,28569,POINT (-87.761826 41.993931),60646-20210128
60636,12/25/2020,0,31,0,31,0.001,0,0,0,30024,POINT (-87.668597 41.77599),60636-20201225
60646,01/30/2021,91,2822,81,2278,0.08,10,544,0.019,28569,POINT (-87.761826 41.993931),60646-20210130
60646,12/27/2020,0,317,0,317,0.011,0,0,0,28569,POINT (-87.761826 41.993931),60646-20201227
60649,12/25/2020,0,121,0,121,0.003,0,0,0,46633,POINT (-87.571522 41.762202),60649-20201225
60607,01/13/2021,195,3036,84,2115,0.072,111,921,0.031,29293,POINT (-87.652727 41.876104),60607-20210113
60631,12/19/2020,74,182,74,182,0.006,0,0,0,29529,POINT (-87.813371 41.995019),60631-20201219
60660,01/29/2021,195,4037,176,3286,0.074,19,751,0.017,44498,POINT (-87.666362 41.991062),60660-20210129
60612,01/02/2021,7,805,7,805,0.024,0,0,0,33735,POINT (-87.687011 41.88004),60612-20210102
60638,01/14/2021,87,1296,72,989,0.017,15,307,0.005,58669,POINT (-87.771902 41.787032),60638-20210114
60641,01/27/2021,216,3453,169,2699,0.039,47,754,0.011,69880,POINT (-87.746791 41.946682),60641-20210127
Unknown,02/22/2021,29,1859,15,1195,0,14,664,0,0,,Unknown-20210222
60666,01/30/2021,0,9,0,9,0,0,0,0,0,POINT (-87.896371 41.979511),60666-20210130
60652,01/02/2021,12,394,12,394,0.009,0,0,0,43447,POINT (-87.714238 41.745398),60652-20210102
60612,12/16/2020,2,2,2,2,0,0,0,0,33735,POINT (-87.687011 41.88004),60612-20201216
60666,01/08/2021,0,0,0,0,0,0,0,0,0,POINT (-87.896371 41.979511),60666-20210108
60645,12/27/2020,0,289,0,289,0.006,0,0,0,47270,POINT (-87.695049 42.008927),60645-20201227
60660,12/20/2020,8,184,8,184,0.004,0,0,0,44498,POINT (-87.666362 41.991062),60660-20201220
60633,01/01/2021,0,48,0,48,0.004,0,0,0,12689,POINT (-87.556037 41.653147),60633-20210101
Unknown,01/21/2021,103,624,99,540,0,4,84,0,0,,Unknown-20210121
60645,12/23/2020,36,273,36,273,0.006,0,0,0,47270,POINT (-87.695049 42.008927),60645-20201223
60619,01/01/2021,0,267,0,267,0.004,0,0,0,61207,POINT (-87.60569 41.744737),60619-20210101
60827,02/16/2021,3,153,0,119,0.004,3,34,0.001,28483,POINT (-87.633087 41.650765),60827-20210216
60633,02/14/2021,14,884,14,712,0.056,0,172,0.014,12689,POINT (-87.556037 41.653147),60633-20210214
60646,01/31/2021,26,2848,23,2301,0.081,3,547,0.019,28569,POINT (-87.761826 41.993931),60646-20210131
60647,12/16/2020,8,8,8,8,0,0,0,0,87633,POINT (-87.701101 41.921058),60647-20201216
60624,01/29/2021,112,1011,106,850,0.024,6,161,0.005,34892,POINT (-87.722735 41.879417),60624-20210129
60827,01/08/2021,3,18,1,16,0.001,2,2,0,28483,POINT (-87.633087 41.650765),60827-20210108
60647,01/04/2021,82,1494,75,1487,0.017,7,7,0,87633,POINT (-87.701101 41.921058),60647-20210104
60647,01/09/2021,174,2393,50,1888,0.022,124,505,0.006,87633,POINT (-87.701101 41.921058),60647-20210109
60643,01/03/2021,13,483,12,482,0.01,1,1,0,48887,POINT (-87.662381 41.700445),60643-20210103
Unknown,02/02/2021,42,1012,20,851,0,22,161,0,0,,Unknown-20210202
60651,01/16/2021,27,735,24,632,0.01,3,103,0.002,63492,POINT (-87.741017 41.901964),60651-20210116
60633,01/24/2021,6,253,5,205,0.016,1,48,0.004,12689,POINT (-87.556037 41.653147),60633-20210124
60609,12/18/2020,32,41,32,41,0.001,0,0,0,60939,POINT (-87.653382 41.812017),60609-20201218
60666,02/09/2021,6,20,5,19,0,1,1,0,0,POINT (-87.896371 41.979511),60666-20210209
60622,12/26/2020,16,1378,16,1378,0.026,0,0,0,53294,POINT (-87.681818 41.902762),60622-20201226
60606,02/13/2021,18,748,9,522,0.159,9,226,0.069,3287,POINT (-87.63676 41.882634),60606-20210213
60632,12/27/2020,0,160,0,160,0.002,0,0,0,89857,POINT (-87.711251 41.810038),60632-20201227
60653,12/28/2020,23,192,23,192,0.006,0,0,0,33154,POINT (-87.611244 41.819261),60653-20201228
Unknown,12/19/2020,1,9,1,9,0,0,0,0,0,,Unknown-20201219
60651,12/16/2020,0,0,0,0,0,0,0,0,63492,POINT (-87.741017 41.901964),60651-20201216
60661,01/19/2021,36,1125,12,747,0.072,24,378,0.037,10354,POINT (-87.644283 41.882786),60661-20210119
60628,01/01/2021,1,232,1,232,0.004,0,0,0,64254,POINT (-87.621537 41.694192),60628-20210101
60602,01/05/2021,9,59,8,58,0.051,1,1,0.001,1145,POINT (-87.628309 41.883136),60602-20210105
60639,12/25/2020,0,216,0,216,0.002,0,0,0,88204,POINT (-87.75531 41.920609),60639-20201225
60642,01/09/2021,103,1197,27,915,0.046,76,282,0.014,19716,POINT (-87.657821 41.899935),60642-20210109
60616,12/25/2020,0,648,0,648,0.012,0,0,0,54197,POINT (-87.629531 41.844869),60616-20201225
60613,01/24/2021,50,4505,45,3394,0.067,5,1111,0.022,50761,POINT (-87.661343 41.953742),60613-20210124
60609,01/31/2021,24,2520,22,2092,0.034,2,428,0.007,60939,POINT (-87.653382 41.812017),60609-20210131
60608,12/25/2020,1,565,1,565,0.007,0,0,0,80059,POINT (-87.670366 41.849879),60608-20201225
60624,01/24/2021,3,644,2,546,0.016,1,98,0.003,34892,POINT (-87.722735 41.879417),60624-20210124
60649,01/07/2021,40,440,23,418,0.009,17,22,0,46633,POINT (-87.571522 41.762202),60649-20210107
60625,01/25/2021,248,4597,165,3590,0.045,83,1007,0.013,79444,POINT (-87.701816 41.971155),60625-20210125
60637,01/28/2021,148,3547,118,2728,0.058,30,819,0.017,47300,POINT (-87.604053 41.780991),60637-20210128
60626,12/31/2020,32,748,32,748,0.015,0,0,0,50544,POINT (-87.669834 42.009469),60626-20201231
60602,12/24/2020,2,30,2,30,0.026,0,0,0,1145,POINT (-87.628309 41.883136),60602-20201224
60607,12/29/2020,117,1179,117,1179,0.04,0,0,0,29293,POINT (-87.652727 41.876104),60607-20201229
60647,12/30/2020,124,1285,124,1285,0.015,0,0,0,87633,POINT (-87.701101 41.921058),60647-20201230
60649,01/22/2021,162,1677,153,1492,0.032,9,185,0.004,46633,POINT (-87.571522 41.762202),60649-20210122
Unknown,02/07/2021,3,1261,3,967,0,0,294,0,0,,Unknown-20210207
60639,01/04/2021,66,483,63,479,0.005,3,4,0,88204,POINT (-87.75531 41.920609),60639-20210104
60624,01/07/2021,26,213,15,201,0.006,11,12,0,34892,POINT (-87.722735 41.879417),60624-20210107
60666,02/04/2021,1,14,1,14,0,0,0,0,0,POINT (-87.896371 41.979511),60666-20210204
60630,12/25/2020,0,426,0,426,0.008,0,0,0,56433,POINT (-87.759611 41.971261),60630-20201225
60632,12/22/2020,34,118,34,118,0.001,0,0,0,89857,POINT (-87.711251 41.810038),60632-20201222
60607,01/11/2021,151,2617,29,1956,0.067,122,661,0.023,29293,POINT (-87.652727 41.876104),60607-20210111
60622,12/31/2020,97,2091,97,2091,0.039,0,0,0,53294,POINT (-87.681818 41.902762),60622-20201231
60619,12/23/2020,25,111,25,111,0.002,0,0,0,61207,POINT (-87.60569 41.744737),60619-20201223
60630,01/15/2021,73,1855,66,1444,0.026,7,411,0.007,56433,POINT (-87.759611 41.971261),60630-20210115
60827,01/19/2021,3,39,3,34,0.001,0,5,0,28483,POINT (-87.633087 41.650765),60827-20210119
60616,01/30/2021,167,4773,144,3652,0.067,23,1121,0.021,54197,POINT (-87.629531 41.844869),60616-20210130
60645,01/28/2021,172,3688,145,2951,0.062,27,737,0.016,47270,POINT (-87.695049 42.008927),60645-20210128
60633,02/25/2021,56,1247,38,911,0.072,18,336,0.026,12689,POINT (-87.556037 41.653147),60633-20210225
60656,01/12/2021,31,619,16,449,0.016,15,170,0.006,28218,POINT (-87.817934 41.974566),60656-20210112
60636,01/21/2021,64,376,53,319,0.011,11,57,0.002,30024,POINT (-87.668597 41.77599),60636-20210121
60641,01/17/2021,24,2012,12,1576,0.023,12,436,0.006,69880,POINT (-87.746791 41.946682),60641-20210117
60657,01/06/2021,148,2722,99,2650,0.037,49,72,0.001,70958,POINT (-87.658216 41.939715),60657-20210106
60630,01/09/2021,75,1333,21,1110,0.02,54,223,0.004,56433,POINT (-87.759611 41.971261),60630-20210109
60651,01/21/2021,132,1052,122,866,0.014,10,186,0.003,63492,POINT (-87.741017 41.901964),60651-20210121
Unknown,01/28/2021,83,893,77,768,0,6,125,0,0,,Unknown-20210128
60638,12/28/2020,30,357,30,357,0.006,0,0,0,58669,POINT (-87.771902 41.787032),60638-20201228
60602,01/10/2021,2,80,1,65,0.057,1,15,0.013,1145,POINT (-87.628309 41.883136),60602-20210110
60630,12/18/2020,96,129,96,129,0.002,0,0,0,56433,POINT (-87.759611 41.971261),60630-20201218
60616,01/03/2021,20,951,18,949,0.018,2,2,0,54197,POINT (-87.629531 41.844869),60616-20210103
60629,12/19/2020,33,102,33,102,0.001,0,0,0,110029,POINT (-87.711565 41.777061),60629-20201219
60631,01/27/2021,173,2603,140,2096,0.071,33,507,0.017,29529,POINT (-87.813371 41.995019),60631-20210127
60640,01/17/2021,42,4097,34,3368,0.049,8,729,0.011,69363,POINT (-87.662232 41.971888),60640-20210117
60632,12/17/2020,12,15,12,15,0,0,0,0,89857,POINT (-87.711251 41.810038),60632-20201217
60621,12/30/2020,71,177,71,177,0.006,0,0,0,28018,POINT (-87.638812 41.776931),60621-20201230
60707,01/01/2021,0,120,0,120,0.003,0,0,0,43093,POINT (-87.808283 41.921777),60707-20210101
60617,01/25/2021,131,2266,102,1912,0.023,29,354,0.004,83553,POINT (-87.556897 41.721257),60617-20210125
60642,12/29/2020,52,603,52,603,0.031,0,0,0,19716,POINT (-87.657821 41.899935),60642-20201229
60613,01/09/2021,139,2131,46,1727,0.034,93,404,0.008,50761,POINT (-87.661343 41.953742),60613-20210109
60630,01/26/2021,155,2992,105,2316,0.041,50,676,0.012,56433,POINT (-87.759611 41.971261),60630-20210126
60611,01/17/2021,43,5017,11,3346,0.101,32,1671,0.05,33224,POINT (-87.620291 41.894734),60611-20210117
60628,01/27/2021,163,1742,152,1503,0.023,11,239,0.004,64254,POINT (-87.621537 41.694192),60628-20210127
60636,01/01/2021,0,84,0,84,0.003,0,0,0,30024,POINT (-87.668597 41.77599),60636-20210101
60637,12/21/2020,34,177,34,177,0.004,0,0,0,47300,POINT (-87.604053 41.780991),60637-20201221
60623,01/02/2021,13,407,13,407,0.005,0,0,0,81283,POINT (-87.717446 41.850321),60623-20210102
60661,01/04/2021,34,512,29,507,0.049,5,5,0,10354,POINT (-87.644283 41.882786),60661-20210104
60624,12/28/2020,6,65,6,65,0.002,0,0,0,34892,POINT (-87.722735 41.879417),60624-20201228
60657,12/20/2020,46,767,46,767,0.011,0,0,0,70958,POINT (-87.658216 41.939715),60657-20201220
60640,01/05/2021,143,1668,136,1654,0.024,7,14,0,69363,POINT (-87.662232 41.971888),60640-20210105
60827,02/03/2021,8,100,6,83,0.003,2,17,0.001,28483,POINT (-87.633087 41.650765),60827-20210203
60651,12/20/2020,4,50,4,50,0.001,0,0,0,63492,POINT (-87.741017 41.901964),60651-20201220
60617,01/12/2021,87,845,57,697,0.008,30,148,0.002,83553,POINT (-87.556897 41.721257),60617-20210112
60622,12/23/2020,124,1337,124,1337,0.025,0,0,0,53294,POINT (-87.681818 41.902762),60622-20201223
60633,01/09/2021,1,98,1,87,0.007,0,11,0.001,12689,POINT (-87.556037 41.653147),60633-20210109
60618,12/15/2020,0,0,0,0,0,0,0,0,94907,POINT (-87.703343 41.946699),60618-20201215
60655,12/26/2020,5,380,5,380,0.013,0,0,0,28569,POINT (-87.701434 41.696456),60655-20201226
60651,01/09/2021,17,477,11,433,0.007,6,44,0.001,63492,POINT (-87.741017 41.901964),60651-20210109
60617,12/20/2020,10,82,10,82,0.001,0,0,0,83553,POINT (-87.556897 41.721257),60617-20201220
60636,01/04/2021,11,101,11,101,0.003,0,0,0,30024,POINT (-87.668597 41.77599),60636-20210104
60607,02/02/2021,159,5691,84,3838,0.131,75,1853,0.063,29293,POINT (-87.652727 41.876104),60607-20210202
60623,12/20/2020,6,56,6,56,0.001,0,0,0,81283,POINT (-87.717446 41.850321),60623-20201220
60641,01/08/2021,147,1239,65,1069,0.015,82,170,0.002,69880,POINT (-87.746791 41.946682),60641-20210108
60622,01/20/2021,263,5307,151,3743,0.07,112,1564,0.029,53294,POINT (-87.681818 41.902762),60622-20210120
60631,12/26/2020,6,347,6,347,0.012,0,0,0,29529,POINT (-87.813371 41.995019),60631-20201226
60631,01/05/2021,49,750,48,748,0.025,1,2,0,29529,POINT (-87.813371 41.995019),60631-20210105
60610,01/30/2021,101,4790,75,3648,0.09,26,1142,0.028,40548,POINT (-87.63581 41.90455),60610-20210130
60605,12/22/2020,218,1033,218,1033,0.036,0,0,0,29060,POINT (-87.623449 41.867824),60605-20201222
60613,01/11/2021,279,2444,144,1885,0.037,135,559,0.011,50761,POINT (-87.661343 41.953742),60613-20210111
60618,12/30/2020,161,1332,161,1332,0.014,0,0,0,94907,POINT (-87.703343 41.946699),60618-20201230
60657,01/17/2021,291,5550,258,4079,0.057,33,1471,0.021,70958,POINT (-87.658216 41.939715),60657-20210117
60625,01/15/2021,112,2876,105,2271,0.029,7,605,0.008,79444,POINT (-87.701816 41.971155),60625-20210115
60629,01/13/2021,105,1231,78,994,0.009,27,237,0.002,110029,POINT (-87.711565 41.777061),60629-20210113
Unknown,02/17/2021,61,1675,21,1130,0,40,545,0,0,,Unknown-20210217
60622,12/16/2020,3,3,3,3,0,0,0,0,53294,POINT (-87.681818 41.902762),60622-20201216
60631,01/12/2021,63,1291,36,1000,0.034,27,291,0.01,29529,POINT (-87.813371 41.995019),60631-20210112
60601,01/24/2021,11,1407,10,1013,0.067,1,394,0.026,15083,POINT (-87.622844 41.886262),60601-20210124
Unknown,12/28/2020,2,43,2,43,0,0,0,0,0,,Unknown-20201228
60707,01/06/2021,10,154,9,152,0.004,1,2,0,43093,POINT (-87.808283 41.921777),60707-20210106
60601,01/10/2021,12,717,3,562,0.037,9,155,0.01,15083,POINT (-87.622844 41.886262),60601-20210110
60620,01/10/2021,9,646,2,574,0.008,7,72,0.001,67711,POINT (-87.651656 41.740873),60620-20210110
60641,01/23/2021,104,2850,97,2239,0.032,7,611,0.009,69880,POINT (-87.746791 41.946682),60641-20210123
60646,01/13/2021,178,1159,137,871,0.03,41,288,0.01,28569,POINT (-87.761826 41.993931),60646-20210113
60613,12/25/2020,0,804,0,804,0.016,0,0,0,50761,POINT (-87.661343 41.953742),60613-20201225
60636,01/18/2021,12,261,7,228,0.008,5,33,0.001,30024,POINT (-87.668597 41.77599),60636-20210118
60660,01/22/2021,159,2964,136,2470,0.056,23,494,0.011,44498,POINT (-87.666362 41.991062),60660-20210122
60609,01/12/2021,80,827,50,691,0.011,30,136,0.002,60939,POINT (-87.653382 41.812017),60609-20210112
60605,01/23/2021,97,4355,84,2836,0.098,13,1519,0.052,29060,POINT (-87.623449 41.867824),60605-20210123
60646,12/30/2020,43,425,43,425,0.015,0,0,0,28569,POINT (-87.761826 41.993931),60646-20201230
60639,12/30/2020,57,338,57,338,0.004,0,0,0,88204,POINT (-87.75531 41.920609),60639-20201230
60644,01/06/2021,34,603,32,601,0.013,2,2,0,46591,POINT (-87.756863 41.881113),60644-20210106
60606,12/15/2020,0,0,0,0,0,0,0,0,3287,POINT (-87.63676 41.882634),60606-20201215
60827,01/02/2021,0,9,0,9,0,0,0,0,28483,POINT (-87.633087 41.650765),60827-20210102
60639,12/18/2020,41,51,41,51,0.001,0,0,0,88204,POINT (-87.75531 41.920609),60639-20201218
60656,12/28/2020,17,214,17,214,0.008,0,0,0,28218,POINT (-87.817934 41.974566),60656-20201228
60623,01/13/2021,69,1013,36,884,0.011,33,129,0.002,81283,POINT (-87.717446 41.850321),60623-20210113
60653,12/19/2020,21,58,21,58,0.002,0,0,0,33154,POINT (-87.611244 41.819261),60653-20201219
60651,01/26/2021,105,1422,83,1184,0.019,22,238,0.004,63492,POINT (-87.741017 41.901964),60651-20210126
60602,01/20/2021,10,161,8,118,0.103,2,43,0.038,1145,POINT (-87.628309 41.883136),60602-20210120
60609,12/23/2020,36,173,36,173,0.003,0,0,0,60939,POINT (-87.653382 41.812017),60609-20201223
60641,12/22/2020,56,358,56,358,0.005,0,0,0,69880,POINT (-87.746791 41.946682),60641-20201222
60606,12/26/2020,1,91,1,91,0.028,0,0,0,3287,POINT (-87.63676 41.882634),60606-20201226
60644,01/21/2021,85,1159,78,1035,0.022,7,124,0.003,46591,POINT (-87.756863 41.881113),60644-20210121
60633,12/28/2020,4,30,4,30,0.002,0,0,0,12689,POINT (-87.556037 41.653147),60633-20201228
60649,12/21/2020,14,64,14,64,0.001,0,0,0,46633,POINT (-87.571522 41.762202),60649-20201221
60624,01/12/2021,35,302,28,263,0.008,7,39,0.001,34892,POINT (-87.722735 41.879417),60624-20210112
60610,01/13/2021,105,2083,54,1468,0.036,51,615,0.015,40548,POINT (-87.63581 41.90455),60610-20210113
60656,01/16/2021,22,769,18,565,0.02,4,204,0.007,28218,POINT (-87.817934 41.974566),60656-20210116
60629,01/08/2021,93,873,56,798,0.007,37,75,0.001,110029,POINT (-87.711565 41.777061),60629-20210108
60629,01/30/2021,180,3709,153,3078,0.028,27,631,0.006,110029,POINT (-87.711565 41.777061),60629-20210130
60638,01/18/2021,56,1461,46,1122,0.019,10,339,0.006,58669,POINT (-87.771902 41.787032),60638-20210118
60606,01/12/2021,19,247,4,165,0.05,15,82,0.025,3287,POINT (-87.63676 41.882634),60606-20210112
60643,12/31/2020,17,458,17,458,0.009,0,0,0,48887,POINT (-87.662381 41.700445),60643-20201231
60611,12/21/2020,424,1340,424,1340,0.04,0,0,0,33224,POINT (-87.620291 41.894734),60611-20201221
60646,12/29/2020,47,382,47,382,0.013,0,0,0,28569,POINT (-87.761826 41.993931),60646-20201229
60611,12/16/2020,15,15,15,15,0,0,0,0,33224,POINT (-87.620291 41.894734),60611-20201216
60827,12/18/2020,4,4,4,4,0,0,0,0,28483,POINT (-87.633087 41.650765),60827-20201218
60601,01/07/2021,56,575,17,525,0.035,39,50,0.003,15083,POINT (-87.622844 41.886262),60601-20210107
60631,12/15/2020,0,0,0,0,0,0,0,0,29529,POINT (-87.813371 41.995019),60631-20201215
60707,12/20/2020,4,29,4,29,0.001,0,0,0,43093,POINT (-87.808283 41.921777),60707-20201220
60642,01/27/2021,88,2368,56,1590,0.081,32,778,0.039,19716,POINT (-87.657821 41.899935),60642-20210127
60633,01/13/2021,9,122,6,100,0.008,3,22,0.002,12689,POINT (-87.556037 41.653147),60633-20210113
60601,12/23/2020,30,299,30,299,0.02,0,0,0,15083,POINT (-87.622844 41.886262),60601-20201223
60614,12/31/2020,44,1798,44,1798,0.025,0,0,0,71954,POINT (-87.652064 41.922605),60614-20201231
60620,12/24/2020,10,133,10,133,0.002,0,0,0,67711,POINT (-87.651656 41.740873),60620-20201224
60633,02/10/2021,53,740,30,607,0.048,23,133,0.01,12689,POINT (-87.556037 41.653147),60633-20210210
60656,12/15/2020,0,0,0,0,0,0,0,0,28218,POINT (-87.817934 41.974566),60656-20201215
60632,01/28/2021,243,2562,207,2123,0.024,36,439,0.005,89857,POINT (-87.711251 41.810038),60632-20210128
60827,02/20/2021,10,184,4,130,0.005,6,54,0.002,28483,POINT (-87.633087 41.650765),60827-20210220
60652,01/12/2021,54,707,30,602,0.014,24,105,0.002,43447,POINT (-87.714238 41.745398),60652-20210112
Unknown,12/15/2020,0,0,0,0,0,0,0,0,0,,Unknown-20201215
60608,01/06/2021,71,1173,58,1150,0.014,13,23,0,80059,POINT (-87.670366 41.849879),60608-20210106
Unknown,01/31/2021,2,955,2,818,0,0,137,0,0,,Unknown-20210131
60602,01/25/2021,11,219,9,173,0.151,2,46,0.04,1145,POINT (-87.628309 41.883136),60602-20210125
60661,12/18/2020,88,136,88,136,0.013,0,0,0,10354,POINT (-87.644283 41.882786),60661-20201218
60640,01/10/2021,32,2785,17,2444,0.035,15,341,0.005,69363,POINT (-87.662232 41.971888),60640-20210110
60661,01/15/2021,29,1036,26,701,0.068,3,335,0.032,10354,POINT (-87.644283 41.882786),60661-20210115
60628,12/28/2020,31,143,31,143,0.002,0,0,0,64254,POINT (-87.621537 41.694192),60628-20201228
60606,01/27/2021,16,437,13,304,0.092,3,133,0.04,3287,POINT (-87.63676 41.882634),60606-20210127
60660,12/17/2020,28,30,28,30,0.001,0,0,0,44498,POINT (-87.666362 41.991062),60660-20201217
60607,01/26/2021,282,4733,218,3213,0.11,64,1520,0.052,29293,POINT (-87.652727 41.876104),60607-20210126
60609,01/27/2021,143,1987,121,1624,0.027,22,363,0.006,60939,POINT (-87.653382 41.812017),60609-20210127
60661,12/24/2020,11,351,11,351,0.034,0,0,0,10354,POINT (-87.644283 41.882786),60661-20201224
60651,12/25/2020,0,112,0,112,0.002,0,0,0,63492,POINT (-87.741017 41.901964),60651-20201225
60617,01/30/2021,151,3590,142,3106,0.037,9,484,0.006,83553,POINT (-87.556897 41.721257),60617-20210130
60633,01/28/2021,27,351,22,283,0.022,5,68,0.005,12689,POINT (-87.556037 41.653147),60633-20210128
60619,01/20/2021,122,1188,90,1007,0.016,32,181,0.003,61207,POINT (-87.60569 41.744737),60619-20210120
60616,01/26/2021,204,3742,140,2747,0.051,64,995,0.018,54197,POINT (-87.629531 41.844869),60616-20210126
60643,01/13/2021,327,1423,296,1131,0.023,31,292,0.006,48887,POINT (-87.662381 41.700445),60643-20210113
60628,01/22/2021,111,1262,104,1071,0.017,7,191,0.003,64254,POINT (-87.621537 41.694192),60628-20210122
60649,01/03/2021,11,328,11,328,0.007,0,0,0,46633,POINT (-87.571522 41.762202),60649-20210103
60637,01/12/2021,61,1330,24,1035,0.022,37,295,0.006,47300,POINT (-87.604053 41.780991),60637-20210112
60630,12/29/2020,64,533,64,533,0.009,0,0,0,56433,POINT (-87.759611 41.971261),60630-20201229
60666,01/03/2021,0,0,0,0,0,0,0,0,0,POINT (-87.896371 41.979511),60666-20210103
60636,12/17/2020,3,3,3,3,0,0,0,0,30024,POINT (-87.668597 41.77599),60636-20201217
60707,01/16/2021,10,325,10,260,0.006,0,65,0.002,43093,POINT (-87.808283 41.921777),60707-20210116
60657,01/02/2021,64,2136,64,2136,0.03,0,0,0,70958,POINT (-87.658216 41.939715),60657-20210102
60616,01/07/2021,195,1449,108,1311,0.024,87,138,0.003,54197,POINT (-87.629531 41.844869),60616-20210107
60652,12/26/2020,2,157,2,157,0.004,0,0,0,43447,POINT (-87.714238 41.745398),60652-20201226
60607,12/25/2020,0,997,0,997,0.034,0,0,0,29293,POINT (-87.652727 41.876104),60607-20201225
60632,01/06/2021,32,547,26,539,0.006,6,8,0,89857,POINT (-87.711251 41.810038),60632-20210106
60666,01/20/2021,0,2,0,2,0,0,0,0,0,POINT (-87.896371 41.979511),60666-20210120
60656,12/30/2020,26,271,26,271,0.01,0,0,0,28218,POINT (-87.817934 41.974566),60656-20201230
60622,01/07/2021,280,2862,86,2625,0.049,194,237,0.004,53294,POINT (-87.681818 41.902762),60622-20210107
60640,12/31/2020,58,1193,58,1193,0.017,0,0,0,69363,POINT (-87.662232 41.971888),60640-20201231
60629,12/29/2020,81,401,81,401,0.004,0,0,0,110029,POINT (-87.711565 41.777061),60629-20201229
60625,01/05/2021,127,1435,124,1428,0.018,3,7,0,79444,POINT (-87.701816 41.971155),60625-20210105
60630,01/30/2021,151,3779,137,2981,0.053,14,798,0.014,56433,POINT (-87.759611 41.971261),60630-20210130
60605,01/18/2021,93,3625,40,2340,0.081,53,1285,0.044,29060,POINT (-87.623449 41.867824),60605-20210118
60625,01/20/2021,284,3541,201,2742,0.035,83,799,0.01,79444,POINT (-87.701816 41.971155),60625-20210120
60631,01/16/2021,92,1570,88,1239,0.042,4,331,0.011,29529,POINT (-87.813371 41.995019),60631-20210116
60628,12/23/2020,20,101,20,101,0.002,0,0,0,64254,POINT (-87.621537 41.694192),60628-20201223
60656,01/31/2021,15,1607,14,1264,0.045,1,343,0.012,28218,POINT (-87.817934 41.974566),60656-20210131
60638,12/24/2020,11,322,11,322,0.005,0,0,0,58669,POINT (-87.771902 41.787032),60638-20201224
60608,12/18/2020,118,153,118,153,0.002,0,0,0,80059,POINT (-87.670366 41.849879),60608-20201218
60827,01/30/2021,8,83,7,71,0.002,1,12,0,28483,POINT (-87.633087 41.650765),60827-20210130
60640,01/15/2021,131,3974,121,3267,0.047,10,707,0.01,69363,POINT (-87.662232 41.971888),60640-20210115
60666,12/19/2020,0,0,0,0,0,0,0,0,0,POINT (-87.896371 41.979511),60666-20201219
60653,01/01/2021,0,399,0,399,0.012,0,0,0,33154,POINT (-87.611244 41.819261),60653-20210101
60661,12/31/2020,23,461,23,461,0.045,0,0,0,10354,POINT (-87.644283 41.882786),60661-20201231
Unknown,01/01/2021,0,87,0,87,0,0,0,0,0,,Unknown-20210101
60602,12/19/2020,5,13,5,13,0.011,0,0,0,1145,POINT (-87.628309 41.883136),60602-20201219
60610,12/29/2020,68,779,68,779,0.019,0,0,0,40548,POINT (-87.63581 41.90455),60610-20201229
60633,12/18/2020,2,4,2,4,0,0,0,0,12689,POINT (-87.556037 41.653147),60633-20201218
60611,01/04/2021,54,2128,46,2120,0.064,8,8,0,33224,POINT (-87.620291 41.894734),60611-20210104
60656,12/29/2020,31,245,31,245,0.009,0,0,0,28218,POINT (-87.817934 41.974566),60656-20201229
60646,01/09/2021,52,851,10,688,0.024,42,163,0.006,28569,POINT (-87.761826 41.993931),60646-20210109
60622,01/24/2021,36,6012,34,4318,0.081,2,1694,0.032,53294,POINT (-87.681818 41.902762),60622-20210124
60656,01/20/2021,67,908,54,676,0.024,13,232,0.008,28218,POINT (-87.817934 41.974566),60656-20210120
60629,01/01/2021,0,523,0,523,0.005,0,0,0,110029,POINT (-87.711565 41.777061),60629-20210101
60630,01/18/2021,68,2012,40,1560,0.028,28,452,0.008,56433,POINT (-87.759611 41.971261),60630-20210118
60637,01/15/2021,131,1601,97,1228,0.026,34,373,0.008,47300,POINT (-87.604053 41.780991),60637-20210115
60629,01/20/2021,145,1831,97,1450,0.013,48,381,0.003,110029,POINT (-87.711565 41.777061),60629-20210120
60632,01/29/2021,298,2860,268,2391,0.027,30,469,0.005,89857,POINT (-87.711251 41.810038),60632-20210129
60632,01/18/2021,53,1122,34,947,0.011,19,175,0.002,89857,POINT (-87.711251 41.810038),60632-20210118
Unknown,02/21/2021,5,1830,4,1180,0,1,650,0,0,,Unknown-20210221
60618,01/06/2021,128,1922,110,1886,0.02,18,36,0,94907,POINT (-87.703343 41.946699),60618-20210106
60631,01/09/2021,66,1152,10,944,0.032,56,208,0.007,29529,POINT (-87.813371 41.995019),60631-20210109
60622,12/19/2020,247,698,247,698,0.013,0,0,0,53294,POINT (-87.681818 41.902762),60622-20201219
60620,01/14/2021,41,838,35,708,0.01,6,130,0.002,67711,POINT (-87.651656 41.740873),60620-20210114
60631,01/24/2021,30,2219,26,1799,0.061,4,420,0.014,29529,POINT (-87.813371 41.995019),60631-20210124
60606,02/10/2021,19,665,13,481,0.146,6,184,0.056,3287,POINT (-87.63676 41.882634),60606-20210210
60605,12/18/2020,267,401,267,401,0.014,0,0,0,29060,POINT (-87.623449 41.867824),60605-20201218
60652,01/23/2021,40,1242,38,999,0.023,2,243,0.006,43447,POINT (-87.714238 41.745398),60652-20210123
60623,12/24/2020,8,155,8,155,0.002,0,0,0,81283,POINT (-87.717446 41.850321),60623-20201224
60617,01/16/2021,29,1123,24,924,0.011,5,199,0.002,83553,POINT (-87.556897 41.721257),60617-20210116
60621,01/02/2021,1,180,1,180,0.006,0,0,0,28018,POINT (-87.638812 41.776931),60621-20210102
60626,12/22/2020,43,274,43,274,0.005,0,0,0,50544,POINT (-87.669834 42.009469),60626-20201222
60707,01/10/2021,7,209,2,184,0.004,5,25,0.001,43093,POINT (-87.808283 41.921777),60707-20210110
60666,01/15/2021,0,1,0,1,0,0,0,0,0,POINT (-87.896371 41.979511),60666-20210115
60649,12/16/2020,0,0,0,0,0,0,0,0,46633,POINT (-87.571522 41.762202),60649-20201216
60641,01/03/2021,18,717,18,717,0.01,0,0,0,69880,POINT (-87.746791 41.946682),60641-20210103
60666,12/25/2020,0,0,0,0,0,0,0,0,0,POINT (-87.896371 41.979511),60666-20201225
60656,01/03/2021,4,310,4,310,0.011,0,0,0,28218,POINT (-87.817934 41.974566),60656-20210103
60636,12/28/2020,10,43,10,43,0.001,0,0,0,30024,POINT (-87.668597 41.77599),60636-20201228
60644,01/18/2021,18,991,11,909,0.02,7,82,0.002,46591,POINT (-87.756863 41.881113),60644-20210118
60645,12/30/2020,152,604,152,604,0.013,0,0,0,47270,POINT (-87.695049 42.008927),60645-20201230
60660,01/26/2021,152,3375,102,2776,0.062,50,599,0.013,44498,POINT (-87.666362 41.991062),60660-20210126
60606,01/26/2021,20,421,18,291,0.089,2,130,0.04,3287,POINT (-87.63676 41.882634),60606-20210126
60613,01/15/2021,112,3227,96,2432,0.048,16,795,0.016,50761,POINT (-87.661343 41.953742),60613-20210115
60655,12/22/2020,46,345,46,345,0.012,0,0,0,28569,POINT (-87.701434 41.696456),60655-20201222
60827,02/25/2021,6,211,3,145,0.005,3,66,0.002,28483,POINT (-87.633087 41.650765),60827-20210225
60606,01/04/2021,10,139,7,136,0.041,3,3,0.001,3287,POINT (-87.63676 41.882634),60606-20210104
60601,01/20/2021,57,1148,40,779,0.052,17,369,0.024,15083,POINT (-87.622844 41.886262),60601-20210120
60613,12/29/2020,142,1044,142,1044,0.021,0,0,0,50761,POINT (-87.661343 41.953742),60613-20201229
60651,12/28/2020,29,144,29,144,0.002,0,0,0,63492,POINT (-87.741017 41.901964),60651-20201228
60601,01/14/2021,37,945,29,658,0.044,8,287,0.019,15083,POINT (-87.622844 41.886262),60601-20210114
60656,12/24/2020,2,194,2,194,0.007,0,0,0,28218,POINT (-87.817934 41.974566),60656-20201224
60646,01/03/2021,5,481,5,481,0.017,0,0,0,28569,POINT (-87.761826 41.993931),60646-20210103
60622,01/19/2021,162,5044,70,3592,0.067,92,1452,0.027,53294,POINT (-87.681818 41.902762),60622-20210119
60649,12/26/2020,1,122,1,122,0.003,0,0,0,46633,POINT (-87.571522 41.762202),60649-20201226
60636,01/14/2021,12,228,10,202,0.007,2,26,0.001,30024,POINT (-87.668597 41.77599),60636-20210114
Unknown,02/14/2021,6,1585,5,1088,0,1,497,0,0,,Unknown-20210214
60606,12/30/2020,16,118,16,118,0.036,0,0,0,3287,POINT (-87.63676 41.882634),60606-20201230
60625,12/19/2020,99,296,99,296,0.004,0,0,0,79444,POINT (-87.701816 41.971155),60625-20201219
60639,12/22/2020,43,175,43,175,0.002,0,0,0,88204,POINT (-87.75531 41.920609),60639-20201222
60638,12/21/2020,54,224,54,224,0.004,0,0,0,58669,POINT (-87.771902 41.787032),60638-20201221
60601,01/03/2021,5,429,5,429,0.028,0,0,0,15083,POINT (-87.622844 41.886262),60601-20210103
60606,01/16/2021,7,278,5,188,0.057,2,90,0.027,3287,POINT (-87.63676 41.882634),60606-20210116
60643,12/27/2020,1,314,1,314,0.006,0,0,0,48887,POINT (-87.662381 41.700445),60643-20201227
60617,12/15/2020,0,0,0,0,0,0,0,0,83553,POINT (-87.556897 41.721257),60617-20201215
60611,12/25/2020,0,1616,0,1616,0.049,0,0,0,33224,POINT (-87.620291 41.894734),60611-20201225
60628,01/06/2021,29,426,28,424,0.007,1,2,0,64254,POINT (-87.621537 41.694192),60628-20210106
60612,12/24/2020,35,523,35,523,0.016,0,0,0,33735,POINT (-87.687011 41.88004),60612-20201224
60623,01/25/2021,142,1928,108,1649,0.02,34,279,0.003,81283,POINT (-87.717446 41.850321),60623-20210125
60827,02/08/2021,5,125,4,104,0.004,1,21,0.001,28483,POINT (-87.633087 41.650765),60827-20210208
60612,12/22/2020,86,412,86,412,0.012,0,0,0,33735,POINT (-87.687011 41.88004),60612-20201222
60652,01/08/2021,50,585,28,542,0.012,22,43,0.001,43447,POINT (-87.714238 41.745398),60652-20210108
60610,01/17/2021,21,2352,14,1685,0.042,7,667,0.016,40548,POINT (-87.63581 41.90455),60610-20210117
60644,12/20/2020,5,30,5,30,0.001,0,0,0,46591,POINT (-87.756863 41.881113),60644-20201220
60827,02/26/2021,13,224,11,156,0.005,2,68,0.002,28483,POINT (-87.633087 41.650765),60827-20210226
60707,12/24/2020,4,75,4,75,0.002,0,0,0,43093,POINT (-87.808283 41.921777),60707-20201224
60642,01/04/2021,45,762,41,758,0.038,4,4,0,19716,POINT (-87.657821 41.899935),60642-20210104
60608,01/02/2021,14,926,14,926,0.012,0,0,0,80059,POINT (-87.670366 41.849879),60608-20210102
60645,01/17/2021,16,1856,14,1582,0.033,2,274,0.006,47270,POINT (-87.695049 42.008927),60645-20210117
60656,12/19/2020,37,105,37,105,0.004,0,0,0,28218,POINT (-87.817934 41.974566),60656-20201219
60643,01/09/2021,51,923,14,748,0.015,37,175,0.004,48887,POINT (-87.662381 41.700445),60643-20210109
60619,01/16/2021,26,901,25,791,0.013,1,110,0.002,61207,POINT (-87.60569 41.744737),60619-20210116
60638,01/05/2021,47,668,44,661,0.011,3,7,0,58669,POINT (-87.771902 41.787032),60638-20210105
60605,12/29/2020,103,1377,103,1377,0.047,0,0,0,29060,POINT (-87.623449 41.867824),60605-20201229
60602,01/13/2021,5,99,4,71,0.062,1,28,0.024,1145,POINT (-87.628309 41.883136),60602-20210113
60601,12/19/2020,43,139,43,139,0.009,0,0,0,15083,POINT (-87.622844 41.886262),60601-20201219
60661,12/28/2020,14,373,14,373,0.036,0,0,0,10354,POINT (-87.644283 41.882786),60661-20201228
60630,01/01/2021,0,651,0,651,0.012,0,0,0,56433,POINT (-87.759611 41.971261),60630-20210101
60602,02/01/2021,13,296,12,236,0.206,1,60,0.052,1145,POINT (-87.628309 41.883136),60602-20210201
60611,01/05/2021,212,2340,193,2313,0.07,19,27,0.001,33224,POINT (-87.620291 41.894734),60611-20210105
60827,01/25/2021,4,52,3,45,0.002,1,7,0,28483,POINT (-87.633087 41.650765),60827-20210125
60656,01/13/2021,59,678,44,493,0.017,15,185,0.007,28218,POINT (-87.817934 41.974566),60656-20210113
60656,01/30/2021,76,1592,63,1250,0.044,13,342,0.012,28218,POINT (-87.817934 41.974566),60656-20210130
60611,01/11/2021,443,4310,80,2986,0.09,363,1324,0.04,33224,POINT (-87.620291 41.894734),60611-20210111
60605,01/13/2021,160,3267,62,2130,0.073,98,1137,0.039,29060,POINT (-87.623449 41.867824),60605-20210113
60628,01/26/2021,120,1579,103,1351,0.021,17,228,0.004,64254,POINT (-87.621537 41.694192),60628-20210126
60624,01/06/2021,18,187,17,186,0.005,1,1,0,34892,POINT (-87.722735 41.879417),60624-20210106
60620,12/28/2020,25,160,25,160,0.002,0,0,0,67711,POINT (-87.651656 41.740873),60620-20201228
60622,01/03/2021,19,2149,18,2148,0.04,1,1,0,53294,POINT (-87.681818 41.902762),60622-20210103
60657,01/11/2021,306,4155,74,3109,0.044,232,1046,0.015,70958,POINT (-87.658216 41.939715),60657-20210111
60630,12/17/2020,29,33,29,33,0.001,0,0,0,56433,POINT (-87.759611 41.971261),60630-20201217
60645,12/16/2020,5,6,5,6,0,0,0,0,47270,POINT (-87.695049 42.008927),60645-20201216
60607,01/22/2021,170,4181,150,2854,0.097,20,1327,0.045,29293,POINT (-87.652727 41.876104),60607-20210122
Unknown,01/13/2021,54,251,44,219,0,10,32,0,0,,Unknown-20210113
60605,01/30/2021,74,5348,51,3557,0.122,23,1791,0.062,29060,POINT (-87.623449 41.867824),60605-20210130
60602,12/16/2020,0,0,0,0,0,0,0,0,1145,POINT (-87.628309 41.883136),60602-20201216
60666,02/12/2021,1,23,1,21,0,0,2,0,0,POINT (-87.896371 41.979511),60666-20210212
60707,01/12/2021,27,253,18,209,0.005,9,44,0.001,43093,POINT (-87.808283 41.921777),60707-20210112
60638,12/31/2020,27,537,27,537,0.009,0,0,0,58669,POINT (-87.771902 41.787032),60638-20201231
60606,01/31/2021,2,499,1,355,0.108,1,144,0.044,3287,POINT (-87.63676 41.882634),60606-20210131
60618,12/24/2020,38,918,38,918,0.01,0,0,0,94907,POINT (-87.703343 41.946699),60618-20201224
60621,12/16/2020,0,0,0,0,0,0,0,0,28018,POINT (-87.638812 41.776931),60621-20201216
60625,01/03/2021,148,1172,148,1172,0.015,0,0,0,79444,POINT (-87.701816 41.971155),60625-20210103
60616,12/17/2020,61,64,61,64,0.001,0,0,0,54197,POINT (-87.629531 41.844869),60616-20201217
60607,12/21/2020,143,685,143,685,0.023,0,0,0,29293,POINT (-87.652727 41.876104),60607-20201221
60613,01/08/2021,269,1992,76,1681,0.033,193,311,0.006,50761,POINT (-87.661343 41.953742),60613-20210108
60619,12/21/2020,18,67,18,67,0.001,0,0,0,61207,POINT (-87.60569 41.744737),60619-20201221
60645,01/31/2021,49,4000,39,3209,0.068,10,791,0.017,47270,POINT (-87.695049 42.008927),60645-20210131
60609,01/24/2021,23,1625,21,1334,0.022,2,291,0.005,60939,POINT (-87.653382 41.812017),60609-20210124
60632,01/10/2021,8,697,1,641,0.007,7,56,0.001,89857,POINT (-87.711251 41.810038),60632-20210110
60617,01/24/2021,43,2135,43,1810,0.022,0,325,0.004,83553,POINT (-87.556897 41.721257),60617-20210124
60606,12/25/2020,0,90,0,90,0.027,0,0,0,3287,POINT (-87.63676 41.882634),60606-20201225
60616,01/11/2021,182,1942,100,1489,0.027,82,453,0.008,54197,POINT (-87.629531 41.844869),60616-20210111
60640,01/11/2021,286,3071,163,2607,0.038,123,464,0.007,69363,POINT (-87.662232 41.971888),60640-20210111
60666,02/27/2021,0,33,0,23,0,0,10,0,0,POINT (-87.896371 41.979511),60666-20210227
60653,01/05/2021,29,459,26,455,0.014,3,4,0,33154,POINT (-87.611244 41.819261),60653-20210105
60630,01/23/2021,111,2669,105,2082,0.037,6,587,0.01,56433,POINT (-87.759611 41.971261),60630-20210123
60609,12/26/2020,2,182,2,182,0.003,0,0,0,60939,POINT (-87.653382 41.812017),60609-20201226
60651,01/29/2021,189,1892,173,1600,0.025,16,292,0.005,63492,POINT (-87.741017 41.901964),60651-20210129
60644,01/30/2021,165,1910,94,1606,0.034,71,304,0.007,46591,POINT (-87.756863 41.881113),60644-20210130
60628,12/27/2020,0,112,0,112,0.002,0,0,0,64254,POINT (-87.621537 41.694192),60628-20201227
60610,01/22/2021,346,3394,326,2535,0.063,20,859,0.021,40548,POINT (-87.63581 41.90455),60610-20210122
60610,01/02/2021,34,936,34,936,0.023,0,0,0,40548,POINT (-87.63581 41.90455),60610-20210102
60632,12/15/2020,0,0,0,0,0,0,0,0,89857,POINT (-87.711251 41.810038),60632-20201215
60637,12/31/2020,46,618,46,618,0.013,0,0,0,47300,POINT (-87.604053 41.780991),60637-20201231
60629,01/05/2021,57,659,55,656,0.006,2,3,0,110029,POINT (-87.711565 41.777061),60629-20210105
60642,12/18/2020,135,187,135,187,0.009,0,0,0,19716,POINT (-87.657821 41.899935),60642-20201218
60613,01/03/2021,21,1258,21,1258,0.025,0,0,0,50761,POINT (-87.661343 41.953742),60613-20210103
60652,12/22/2020,22,116,22,116,0.003,0,0,0,43447,POINT (-87.714238 41.745398),60652-20201222
60618,01/04/2021,142,1641,133,1629,0.017,9,12,0,94907,POINT (-87.703343 41.946699),60618-20210104
60628,01/19/2021,99,913,70,768,0.012,29,145,0.002,64254,POINT (-87.621537 41.694192),60628-20210119
60602,12/31/2020,0,44,0,44,0.038,0,0,0,1145,POINT (-87.628309 41.883136),60602-20201231
60611,12/31/2020,26,2015,26,2015,0.061,0,0,0,33224,POINT (-87.620291 41.894734),60611-20201231
60661,01/12/2021,58,918,20,628,0.061,38,290,0.028,10354,POINT (-87.644283 41.882786),60661-20210112
60623,01/10/2021,7,784,4,736,0.009,3,48,0.001,81283,POINT (-87.717446 41.850321),60623-20210110
60606,01/09/2021,13,202,3,156,0.047,10,46,0.014,3287,POINT (-87.63676 41.882634),60606-20210109
60606,12/20/2020,3,52,3,52,0.016,0,0,0,3287,POINT (-87.63676 41.882634),60606-20201220
60609,12/15/2020,0,0,0,0,0,0,0,0,60939,POINT (-87.653382 41.812017),60609-20201215
60632,12/28/2020,28,188,28,188,0.002,0,0,0,89857,POINT (-87.711251 41.810038),60632-20201228
60610,01/10/2021,30,1703,11,1323,0.033,19,380,0.009,40548,POINT (-87.63581 41.90455),60610-20210110
60624,01/17/2021,4,436,4,381,0.011,0,55,0.002,34892,POINT (-87.722735 41.879417),60624-20210117
60646,12/23/2020,49,304,49,304,0.011,0,0,0,28569,POINT (-87.761826 41.993931),60646-20201223
60639,12/17/2020,7,10,7,10,0,0,0,0,88204,POINT (-87.75531 41.920609),60639-20201217
60618,01/10/2021,26,2626,8,2146,0.023,18,480,0.005,94907,POINT (-87.703343 41.946699),60618-20210110
60638,12/16/2020,0,0,0,0,0,0,0,0,58669,POINT (-87.771902 41.787032),60638-20201216
60624,01/19/2021,29,470,16,402,0.012,13,68,0.002,34892,POINT (-87.722735 41.879417),60624-20210119
60643,12/23/2020,30,302,30,302,0.006,0,0,0,48887,POINT (-87.662381 41.700445),60643-20201223
60633,02/20/2021,27,1072,10,799,0.063,17,273,0.022,12689,POINT (-87.556037 41.653147),60633-20210220
60626,01/11/2021,93,1519,44,1302,0.026,49,217,0.004,50544,POINT (-87.669834 42.009469),60626-20210111
60605,01/04/2021,107,1708,89,1686,0.058,18,22,0.001,29060,POINT (-87.623449 41.867824),60605-20210104
60649,01/17/2021,5,1021,4,908,0.019,1,113,0.002,46633,POINT (-87.571522 41.762202),60649-20210117
60636,01/10/2021,1,174,0,160,0.005,1,14,0,30024,POINT (-87.668597 41.77599),60636-20210110
60660,01/14/2021,82,2177,68,1852,0.042,14,325,0.007,44498,POINT (-87.666362 41.991062),60660-20210114
60617,12/28/2020,40,242,40,242,0.003,0,0,0,83553,POINT (-87.556897 41.721257),60617-20201228
60641,12/17/2020,33,51,33,51,0.001,0,0,0,69880,POINT (-87.746791 41.946682),60641-20201217
60633,12/27/2020,0,26,0,26,0.002,0,0,0,12689,POINT (-87.556037 41.653147),60633-20201227
60617,01/04/2021,36,411,33,408,0.005,3,3,0,83553,POINT (-87.556897 41.721257),60617-20210104
60652,01/19/2021,51,968,23,785,0.018,28,183,0.004,43447,POINT (-87.714238 41.745398),60652-20210119
60606,01/21/2021,24,344,19,225,0.068,5,119,0.036,3287,POINT (-87.63676 41.882634),60606-20210121
60642,12/30/2020,68,671,68,671,0.034,0,0,0,19716,POINT (-87.657821 41.899935),60642-20201230
60612,12/17/2020,42,44,42,44,0.001,0,0,0,33735,POINT (-87.687011 41.88004),60612-20201217
60640,12/27/2020,0,742,0,742,0.011,0,0,0,69363,POINT (-87.662232 41.971888),60640-20201227
60666,12/29/2020,0,0,0,0,0,0,0,0,0,POINT (-87.896371 41.979511),60666-20201229
60651,01/01/2021,0,237,0,237,0.004,0,0,0,63492,POINT (-87.741017 41.901964),60651-20210101
60646,12/21/2020,55,225,55,225,0.008,0,0,0,28569,POINT (-87.761826 41.993931),60646-20201221
60621,01/06/2021,14,219,11,214,0.008,3,5,0,28018,POINT (-87.638812 41.776931),60621-20210106
60631,12/18/2020,85,108,85,108,0.004,0,0,0,29529,POINT (-87.813371 41.995019),60631-20201218
60606,02/22/2021,12,889,3,579,0.176,9,310,0.094,3287,POINT (-87.63676 41.882634),60606-20210222
60633,02/02/2021,34,464,29,386,0.03,5,78,0.006,12689,POINT (-87.556037 41.653147),60633-20210202
60614,12/20/2020,48,680,48,680,0.009,0,0,0,71954,POINT (-87.652064 41.922605),60614-20201220
60649,01/12/2021,95,796,80,715,0.015,15,81,0.002,46633,POINT (-87.571522 41.762202),60649-20210112
60626,01/10/2021,13,1426,4,1258,0.025,9,168,0.003,50544,POINT (-87.669834 42.009469),60626-20210110
60653,01/12/2021,90,800,65,670,0.02,25,130,0.004,33154,POINT (-87.611244 41.819261),60653-20210112
60601,01/31/2021,14,1848,11,1343,0.089,3,505,0.033,15083,POINT (-87.622844 41.886262),60601-20210131
60609,01/04/2021,30,375,30,375,0.006,0,0,0,60939,POINT (-87.653382 41.812017),60609-20210104
60636,12/24/2020,2,31,2,31,0.001,0,0,0,30024,POINT (-87.668597 41.77599),60636-20201224
60644,01/31/2021,11,1921,9,1615,0.035,2,306,0.007,46591,POINT (-87.756863 41.881113),60644-20210131
60657,12/25/2020,0,1450,0,1450,0.02,0,0,0,70958,POINT (-87.658216 41.939715),60657-20201225
Unknown,02/10/2021,54,1402,16,1025,0,38,377,0,0,,Unknown-20210210
60707,01/22/2021,49,569,47,464,0.011,2,105,0.002,43093,POINT (-87.808283 41.921777),60707-20210122
60620,01/02/2021,6,263,6,263,0.004,0,0,0,67711,POINT (-87.651656 41.740873),60620-20210102
60610,01/05/2021,123,1120,114,1103,0.027,9,17,0,40548,POINT (-87.63581 41.90455),60610-20210105
60666,01/26/2021,1,4,1,4,0,0,0,0,0,POINT (-87.896371 41.979511),60666-20210126
60660,01/11/2021,75,1873,33,1638,0.037,42,235,0.005,44498,POINT (-87.666362 41.991062),60660-20210111
60646,01/22/2021,131,1851,120,1445,0.051,11,406,0.014,28569,POINT (-87.761826 41.993931),60646-20210122
60660,01/01/2021,1,590,1,590,0.013,0,0,0,44498,POINT (-87.666362 41.991062),60660-20210101
60601,12/30/2020,34,401,34,401,0.027,0,0,0,15083,POINT (-87.622844 41.886262),60601-20201230
60666,01/11/2021,0,0,0,0,0,0,0,0,0,POINT (-87.896371 41.979511),60666-20210111
60661,01/24/2021,9,1291,4,852,0.082,5,439,0.042,10354,POINT (-87.644283 41.882786),60661-20210124
60633,02/19/2021,50,1045,18,789,0.062,32,256,0.02,12689,POINT (-87.556037 41.653147),60633-20210219
60656,01/25/2021,59,1152,46,885,0.031,13,267,0.009,28218,POINT (-87.817934 41.974566),60656-20210125
60637,01/19/2021,215,2120,184,1618,0.034,31,502,0.011,47300,POINT (-87.604053 41.780991),60637-20210119
60657,12/30/2020,216,2009,216,2009,0.028,0,0,0,70958,POINT (-87.658216 41.939715),60657-20201230
60613,01/30/2021,142,5993,113,4531,0.089,29,1462,0.029,50761,POINT (-87.661343 41.953742),60613-20210130
60625,01/14/2021,104,2764,87,2166,0.027,17,598,0.008,79444,POINT (-87.701816 41.971155),60625-20210114
60637,01/31/2021,69,3826,68,2975,0.063,1,851,0.018,47300,POINT (-87.604053 41.780991),60637-20210131
60625,12/23/2020,107,607,107,607,0.008,0,0,0,79444,POINT (-87.701816 41.971155),60625-20201223
60619,01/11/2021,37,556,21,488,0.008,16,68,0.001,61207,POINT (-87.60569 41.744737),60619-20210111
60642,01/18/2021,48,1701,23,1159,0.059,25,542,0.027,19716,POINT (-87.657821 41.899935),60642-20210118
60646,01/24/2021,28,2062,26,1645,0.058,2,417,0.015,28569,POINT (-87.761826 41.993931),60646-20210124
60625,12/28/2020,61,704,61,704,0.009,0,0,0,79444,POINT (-87.701816 41.971155),60625-20201228
60606,02/05/2021,31,600,23,435,0.132,8,165,0.05,3287,POINT (-87.63676 41.882634),60606-20210205
60612,12/28/2020,58,585,58,585,0.017,0,0,0,33735,POINT (-87.687011 41.88004),60612-20201228
60620,01/07/2021,52,533,32,499,0.007,20,34,0.001,67711,POINT (-87.651656 41.740873),60620-20210107
60655,01/02/2021,128,658,128,658,0.023,0,0,0,28569,POINT (-87.701434 41.696456),60655-20210102
60631,12/23/2020,24,335,24,335,0.011,0,0,0,29529,POINT (-87.813371 41.995019),60631-20201223
60649,12/31/2020,12,309,12,309,0.007,0,0,0,46633,POINT (-87.571522 41.762202),60649-20201231
60629,01/16/2021,129,1518,119,1252,0.011,10,266,0.002,110029,POINT (-87.711565 41.777061),60629-20210116
60649,01/02/2021,8,317,8,317,0.007,0,0,0,46633,POINT (-87.571522 41.762202),60649-20210102
60660,12/24/2020,11,342,11,342,0.008,0,0,0,44498,POINT (-87.666362 41.991062),60660-20201224
60607,01/17/2021,13,3303,9,2316,0.079,4,987,0.034,29293,POINT (-87.652727 41.876104),60607-20210117
60632,01/16/2021,52,1058,45,907,0.01,7,151,0.002,89857,POINT (-87.711251 41.810038),60632-20210116
60611,01/07/2021,228,2644,43,2403,0.072,185,241,0.007,33224,POINT (-87.620291 41.894734),60611-20210107
60657,01/16/2021,158,5259,136,3821,0.054,22,1438,0.02,70958,POINT (-87.658216 41.939715),60657-20210116
60638,01/08/2021,95,885,35,765,0.013,60,120,0.002,58669,POINT (-87.771902 41.787032),60638-20210108
Unknown,02/06/2021,40,1258,16,964,0,24,294,0,0,,Unknown-20210206
60653,12/24/2020,9,169,9,169,0.005,0,0,0,33154,POINT (-87.611244 41.819261),60653-20201224
60827,12/24/2020,1,7,1,7,0,0,0,0,28483,POINT (-87.633087 41.650765),60827-20201224
60655,12/16/2020,0,0,0,0,0,0,0,0,28569,POINT (-87.701434 41.696456),60655-20201216
60602,12/27/2020,0,30,0,30,0.026,0,0,0,1145,POINT (-87.628309 41.883136),60602-20201227
60602,01/17/2021,3,124,2,93,0.081,1,31,0.027,1145,POINT (-87.628309 41.883136),60602-20210117
Unknown,02/25/2021,43,2005,13,1250,0,30,755,0,0,,Unknown-20210225
60618,12/20/2020,24,450,24,450,0.005,0,0,0,94907,POINT (-87.703343 41.946699),60618-20201220
60661,01/29/2021,43,1521,34,998,0.096,9,523,0.051,10354,POINT (-87.644283 41.882786),60661-20210129
60605,12/25/2020,0,1208,0,1208,0.042,0,0,0,29060,POINT (-87.623449 41.867824),60605-20201225
60607,01/02/2021,25,1438,25,1438,0.049,0,0,0,29293,POINT (-87.652727 41.876104),60607-20210102
60637,01/04/2021,70,780,64,769,0.016,6,11,0,47300,POINT (-87.604053 41.780991),60637-20210104
60647,12/20/2020,37,534,37,534,0.006,0,0,0,87633,POINT (-87.701101 41.921058),60647-20201220
60605,01/09/2021,180,2588,30,1949,0.067,150,639,0.022,29060,POINT (-87.623449 41.867824),60605-20210109
60602,01/28/2021,10,255,10,200,0.175,0,55,0.048,1145,POINT (-87.628309 41.883136),60602-20210128
60637,01/22/2021,196,2758,168,2129,0.045,28,629,0.013,47300,POINT (-87.604053 41.780991),60637-20210122
Unknown,01/24/2021,1,692,1,606,0,0,86,0,0,,Unknown-20210124
60622,12/30/2020,294,1994,294,1994,0.037,0,0,0,53294,POINT (-87.681818 41.902762),60622-20201230
60644,01/13/2021,156,891,142,833,0.018,14,58,0.001,46591,POINT (-87.756863 41.881113),60644-20210113
60607,12/16/2020,4,5,4,5,0,0,0,0,29293,POINT (-87.652727 41.876104),60607-20201216
60628,01/30/2021,104,2245,97,1970,0.031,7,275,0.004,64254,POINT (-87.621537 41.694192),60628-20210130
60613,12/19/2020,121,387,121,387,0.008,0,0,0,50761,POINT (-87.661343 41.953742),60613-20201219
Unknown,01/09/2021,12,151,11,143,0,1,8,0,0,,Unknown-20210109
60827,02/13/2021,4,148,2,119,0.004,2,29,0.001,28483,POINT (-87.633087 41.650765),60827-20210213
60626,12/27/2020,0,339,0,339,0.007,0,0,0,50544,POINT (-87.669834 42.009469),60626-20201227
60641,01/18/2021,72,2084,48,1624,0.023,24,460,0.007,69880,POINT (-87.746791 41.946682),60641-20210118
60651,01/22/2021,119,1171,116,982,0.015,3,189,0.003,63492,POINT (-87.741017 41.901964),60651-20210122
60605,01/26/2021,133,4673,73,3025,0.104,60,1648,0.057,29060,POINT (-87.623449 41.867824),60605-20210126
60602,12/20/2020,2,15,2,15,0.013,0,0,0,1145,POINT (-87.628309 41.883136),60602-20201220
60644,12/29/2020,30,173,30,173,0.004,0,0,0,46591,POINT (-87.756863 41.881113),60644-20201229
60645,01/07/2021,109,1152,69,1101,0.023,40,51,0.001,47270,POINT (-87.695049 42.008927),60645-20210107
60827,01/15/2021,3,33,3,28,0.001,0,5,0,28483,POINT (-87.633087 41.650765),60827-20210115
60630,01/06/2021,84,996,64,972,0.017,20,24,0,56433,POINT (-87.759611 41.971261),60630-20210106
60623,01/05/2021,34,498,34,497,0.006,0,1,0,81283,POINT (-87.717446 41.850321),60623-20210105
60640,12/16/2020,3,3,3,3,0,0,0,0,69363,POINT (-87.662232 41.971888),60640-20201216
60616,12/29/2020,76,791,76,791,0.015,0,0,0,54197,POINT (-87.629531 41.844869),60616-20201229
60609,01/19/2021,64,1177,41,946,0.016,23,231,0.004,60939,POINT (-87.653382 41.812017),60609-20210119
60621,12/20/2020,3,18,3,18,0.001,0,0,0,28018,POINT (-87.638812 41.776931),60621-20201220
60645,01/24/2021,24,2508,22,2099,0.044,2,409,0.009,47270,POINT (-87.695049 42.008927),60645-20210124
60641,01/13/2021,152,1711,94,1332,0.019,58,379,0.005,69880,POINT (-87.746791 41.946682),60641-20210113
60639,01/08/2021,90,758,60,691,0.008,30,67,0.001,88204,POINT (-87.75531 41.920609),60639-20210108
60827,01/07/2021,2,15,2,15,0.001,0,0,0,28483,POINT (-87.633087 41.650765),60827-20210107
60633,01/02/2021,5,53,5,53,0.004,0,0,0,12689,POINT (-87.556037 41.653147),60633-20210102
60647,12/26/2020,13,984,13,984,0.011,0,0,0,87633,POINT (-87.701101 41.921058),60647-20201226
60628,01/15/2021,38,753,38,651,0.01,0,102,0.002,64254,POINT (-87.621537 41.694192),60628-20210115
60633,01/04/2021,5,59,5,59,0.005,0,0,0,12689,POINT (-87.556037 41.653147),60633-20210104
60620,12/23/2020,16,123,16,123,0.002,0,0,0,67711,POINT (-87.651656 41.740873),60620-20201223
60631,01/19/2021,96,1745,79,1387,0.047,17,358,0.012,29529,POINT (-87.813371 41.995019),60631-20210119
60661,01/07/2021,65,630,22,570,0.055,43,60,0.006,10354,POINT (-87.644283 41.882786),60661-20210107
60608,12/29/2020,98,704,98,704,0.009,0,0,0,80059,POINT (-87.670366 41.849879),60608-20201229
60619,12/27/2020,0,121,0,121,0.002,0,0,0,61207,POINT (-87.60569 41.744737),60619-20201227
60609,12/30/2020,64,307,64,307,0.005,0,0,0,60939,POINT (-87.653382 41.812017),60609-20201230
60647,12/15/2020,0,0,0,0,0,0,0,0,87633,POINT (-87.701101 41.921058),60647-20201215
60666,02/08/2021,0,14,0,14,0,0,0,0,0,POINT (-87.896371 41.979511),60666-20210208
60633,01/19/2021,19,166,14,134,0.011,5,32,0.003,12689,POINT (-87.556037 41.653147),60633-20210119
60657,12/15/2020,0,0,0,0,0,0,0,0,70958,POINT (-87.658216 41.939715),60657-20201215
60642,12/25/2020,0,513,0,513,0.026,0,0,0,19716,POINT (-87.657821 41.899935),60642-20201225
60639,01/10/2021,84,889,79,790,0.009,5,99,0.001,88204,POINT (-87.75531 41.920609),60639-20210110
60632,12/26/2020,6,160,6,160,0.002,0,0,0,89857,POINT (-87.711251 41.810038),60632-20201226
60607,01/07/2021,214,1988,92,1819,0.062,122,169,0.006,29293,POINT (-87.652727 41.876104),60607-20210107
60644,12/17/2020,4,4,4,4,0,0,0,0,46591,POINT (-87.756863 41.881113),60644-20201217
60630,12/22/2020,33,364,33,364,0.006,0,0,0,56433,POINT (-87.759611 41.971261),60630-20201222
60616,01/18/2021,76,2569,36,1866,0.034,40,703,0.013,54197,POINT (-87.629531 41.844869),60616-20210118
60624,01/02/2021,7,125,7,125,0.004,0,0,0,34892,POINT (-87.722735 41.879417),60624-20210102
60629,12/15/2020,0,0,0,0,0,0,0,0,110029,POINT (-87.711565 41.777061),60629-20201215
60603,02/19/2021,12,567,2,418,0.397,10,149,0.142,1052,POINT (-87.625473 41.880112),60603-20210219
60603,03/01/2021,7,733,4,464,0.441,3,269,0.256,1052,POINT (-87.625473 41.880112),60603-20210301
60633,02/05/2021,44,576,36,478,0.038,8,98,0.008,12689,POINT (-87.556037 41.653147),60633-20210205
60707,12/28/2020,6,81,6,81,0.002,0,0,0,43093,POINT (-87.808283 41.921777),60707-20201228
60641,12/31/2020,30,673,30,673,0.01,0,0,0,69880,POINT (-87.746791 41.946682),60641-20201231
60656,01/08/2021,65,501,17,409,0.014,48,92,0.003,28218,POINT (-87.817934 41.974566),60656-20210108
60642,12/20/2020,25,290,25,290,0.015,0,0,0,19716,POINT (-87.657821 41.899935),60642-20201220
60607,01/12/2021,224,2841,75,2031,0.069,149,810,0.028,29293,POINT (-87.652727 41.876104),60607-20210112
60606,02/17/2021,25,809,12,555,0.169,13,254,0.077,3287,POINT (-87.63676 41.882634),60606-20210217
60605,02/05/2021,237,6269,186,4223,0.145,51,2046,0.07,29060,POINT (-87.623449 41.867824),60605-20210205
60613,01/20/2021,188,3821,117,2791,0.055,71,1030,0.02,50761,POINT (-87.661343 41.953742),60613-20210120
60645,01/04/2021,157,835,155,832,0.018,2,3,0,47270,POINT (-87.695049 42.008927),60645-20210104
60610,12/21/2020,133,480,133,480,0.012,0,0,0,40548,POINT (-87.63581 41.90455),60610-20201221
60625,01/24/2021,59,4349,52,3425,0.043,7,924,0.012,79444,POINT (-87.701816 41.971155),60625-20210124
60827,01/12/2021,4,24,2,20,0.001,2,4,0,28483,POINT (-87.633087 41.650765),60827-20210112
60602,01/06/2021,3,62,3,61,0.053,0,1,0.001,1145,POINT (-87.628309 41.883136),60602-20210106
60661,12/23/2020,27,340,27,340,0.033,0,0,0,10354,POINT (-87.644283 41.882786),60661-20201223
60637,12/18/2020,55,81,55,81,0.002,0,0,0,47300,POINT (-87.604053 41.780991),60637-20201218
60614,12/15/2020,1,1,1,1,0,0,0,0,71954,POINT (-87.652064 41.922605),60614-20201215
60619,12/28/2020,32,153,32,153,0.002,0,0,0,61207,POINT (-87.60569 41.744737),60619-20201228
60652,12/18/2020,27,40,27,40,0.001,0,0,0,43447,POINT (-87.714238 41.745398),60652-20201218
60608,01/30/2021,232,5486,194,4354,0.054,38,1132,0.014,80059,POINT (-87.670366 41.849879),60608-20210130
60612,01/08/2021,144,1244,47,1077,0.032,97,167,0.005,33735,POINT (-87.687011 41.88004),60612-20210108
